ATM Name,Transaction Date,No Of Withdrawals,No Of XYZ Card Withdrawals,No Of Other Card Withdrawals,Total amount Withdrawn,Amount withdrawn XYZ Card,Amount withdrawn Other Card,Weekday,Festival Religion,Working Day,Holiday Sequence
Christ College ATM,01-01-2011,74,25,49,287700,148200,139500,Saturday,C,H,WHH
Christ College ATM,02-01-2011,80,24,56,300000,95600,204400,Sunday,NH,H,HHW
Christ College ATM,03-01-2011,108,46,62,522800,210900,311900,Monday,NH,W,WWW
Christ College ATM,04-01-2011,143,41,102,737400,238000,499400,Tuesday,NH,W,WWW
Christ College ATM,05-01-2011,95,41,54,387300,213600,173700,Wednesday,NH,W,WWW
Christ College ATM,06-01-2011,116,50,66,430500,168700,261800,Thursday,NH,W,WWW
Christ College ATM,07-01-2011,85,46,39,345800,212300,133500,Friday,NH,W,WWW
Christ College ATM,08-01-2011,86,45,41,366500,195500,171000,Saturday,NH,H,WHH
Christ College ATM,09-01-2011,100,40,60,363800,212200,151600,Sunday,NH,H,HHW
Christ College ATM,10-01-2011,116,53,63,545400,315800,229600,Monday,NH,W,HWW
Christ College ATM,11-01-2011,92,36,56,343700,165600,178100,Tuesday,NH,W,WWW
Christ College ATM,12-01-2011,74,37,37,301300,177100,124200,Wednesday,NH,W,WWW
Christ College ATM,13-01-2011,143,52,91,510300,232700,277600,Thursday,NH,W,WWW
Christ College ATM,14-01-2011,91,52,39,373000,241300,131700,Friday,NH,W,WWH
Christ College ATM,15-01-2011,53,30,23,206800,133800,73000,Saturday,H,H,WHH
Christ College ATM,16-01-2011,36,15,21,95200,46100,49100,Sunday,H,H,HHH
Christ College ATM,17-01-2011,46,25,21,126800,69300,57500,Monday,H,H,HHW
Christ College ATM,18-01-2011,82,45,37,380000,216900,163100,Tuesday,NH,W,HWW
Christ College ATM,19-01-2011,124,39,85,446800,121100,325700,Wednesday,NH,W,WWW
Christ College ATM,20-01-2011,140,45,95,571300,244000,327300,Thursday,NH,W,WWW
Christ College ATM,21-01-2011,90,44,46,386800,235800,151000,Friday,NH,W,WWH
Christ College ATM,22-01-2011,95,35,60,465300,240700,224600,Saturday,NH,H,WHH
Christ College ATM,23-01-2011,45,29,16,212500,174200,38300,Sunday,NH,H,HHW
Christ College ATM,24-01-2011,100,43,57,410800,208500,202300,Monday,NH,W,HWW
Christ College ATM,25-01-2011,89,47,42,325900,194000,131900,Tuesday,NH,W,WHW
Christ College ATM,26-01-2011,69,26,43,258400,101200,157200,Wednesday,N,H,WHW
Christ College ATM,27-01-2011,96,41,55,336300,227800,108500,Thursday,NH,W,HWW
Christ College ATM,28-01-2011,77,36,41,254500,169400,85100,Friday,NH,W,WWH
Christ College ATM,29-01-2011,87,50,37,463400,319200,144200,Saturday,NH,H,WHH
Christ College ATM,30-01-2011,75,27,48,277200,127500,149700,Sunday,NH,H,HHW
Christ College ATM,31-01-2011,91,39,52,369100,179000,190100,Monday,NH,W,HWW
Christ College ATM,01-02-2011,97,31,66,432000,158400,273600,Tuesday,NH,W,WWW
Christ College ATM,02-02-2011,133,55,78,714600,329400,385200,Wednesday,NH,W,WWW
Christ College ATM,03-02-2011,80,36,44,359800,172400,187400,Thursday,NH,W,WWW
Christ College ATM,04-02-2011,78,38,40,382500,220300,162200,Friday,NH,W,WWH
Christ College ATM,05-02-2011,100,46,54,429800,230700,199100,Saturday,NH,H,WHH
Christ College ATM,06-02-2011,92,28,64,292300,78800,213500,Sunday,NH,H,HHW
Christ College ATM,07-02-2011,110,48,62,430000,190600,239400,Monday,NH,W,HWW
Christ College ATM,08-02-2011,93,45,48,343000,175500,167500,Tuesday,NH,W,WWW
Christ College ATM,09-02-2011,81,33,48,381600,153900,227700,Wednesday,NH,W,WWW
Christ College ATM,10-02-2011,91,44,47,348300,236900,111400,Thursday,NH,W,WWW
Christ College ATM,11-02-2011,78,30,48,413300,153600,259700,Friday,NH,W,WWW
Christ College ATM,12-02-2011,99,49,50,452900,259800,193100,Saturday,NH,H,WHH
Christ College ATM,13-02-2011,40,19,21,119000,56500,62500,Sunday,NH,H,HHW
Christ College ATM,14-02-2011,38,17,21,173100,93500,79600,Monday,NH,W,HWW
Christ College ATM,15-02-2011,93,59,34,357700,247900,109800,Tuesday,NH,W,WWH
Christ College ATM,16-02-2011,55,22,33,147100,64000,83100,Wednesday,M,H,WHW
Christ College ATM,17-02-2011,77,26,51,292600,113700,178900,Thursday,NH,W,HWW
Christ College ATM,18-02-2011,66,24,42,200600,59800,140800,Friday,NH,W,WWH
Christ College ATM,19-02-2011,74,41,33,399800,225900,173900,Saturday,NH,H,WHH
Christ College ATM,20-02-2011,62,16,46,169400,61600,107800,Sunday,NH,H,HHW
Christ College ATM,21-02-2011,61,32,29,143200,103000,40200,Monday,NH,W,HWW
Christ College ATM,22-02-2011,100,47,53,370800,200200,170600,Tuesday,NH,W,WWW
Christ College ATM,23-02-2011,63,31,32,265700,165300,100400,Wednesday,NH,W,WWW
Christ College ATM,24-02-2011,76,33,43,255600,113400,142200,Thursday,NH,W,WWW
Christ College ATM,25-02-2011,70,31,39,200500,100400,100100,Friday,NH,W,WWH
Christ College ATM,26-02-2011,91,37,54,375800,197300,178500,Saturday,NH,H,WHH
Christ College ATM,27-02-2011,67,26,41,283700,130200,153500,Sunday,NH,H,HHW
Christ College ATM,28-02-2011,112,54,58,398900,185100,213800,Monday,NH,W,HWW
Christ College ATM,01-03-2011,92,39,53,479800,228700,251100,Tuesday,NH,W,WWW
Christ College ATM,02-03-2011,118,41,77,638200,272200,366000,Wednesday,NH,W,WWW
Christ College ATM,03-03-2011,94,49,45,405100,210300,194800,Thursday,H,W,WWW
Christ College ATM,04-03-2011,88,49,39,423900,257600,166300,Friday,NH,W,WWH
Christ College ATM,05-03-2011,117,57,60,582300,328100,254200,Saturday,NH,H,WHH
Christ College ATM,06-03-2011,76,21,55,333400,114700,218700,Sunday,NH,H,HHW
Christ College ATM,07-03-2011,74,34,40,231800,134400,97400,Monday,NH,W,HWW
Christ College ATM,08-03-2011,91,38,53,323000,144700,178300,Tuesday,NH,W,WWW
Christ College ATM,09-03-2011,109,65,44,450700,288000,162700,Wednesday,NH,W,WWW
Christ College ATM,10-03-2011,93,40,53,385100,145000,240100,Thursday,NH,W,WWW
Christ College ATM,11-03-2011,77,37,40,312900,168100,144800,Friday,NH,W,WWW
Christ College ATM,12-03-2011,67,36,31,262300,98100,164200,Saturday,NH,H,WHH
Christ College ATM,13-03-2011,52,19,33,153200,54800,98400,Sunday,NH,H,HHW
Christ College ATM,14-03-2011,77,38,39,283200,154000,129200,Monday,NH,W,HWW
Christ College ATM,15-03-2011,61,31,30,183900,89700,94200,Tuesday,NH,W,WWW
Christ College ATM,16-03-2011,61,32,29,220200,138700,81500,Wednesday,NH,W,WWW
Christ College ATM,17-03-2011,55,29,26,238800,144700,94100,Thursday,NH,W,WWW
Christ College ATM,18-03-2011,74,48,26,290000,192200,97800,Friday,NH,W,WWH
Christ College ATM,19-03-2011,92,50,42,345600,234000,111600,Saturday,NH,H,WHH
Christ College ATM,20-03-2011,48,27,21,164400,120200,44200,Sunday,H,H,HHW
Christ College ATM,21-03-2011,60,36,24,287700,213700,74000,Monday,NH,W,HWW
Christ College ATM,22-03-2011,69,38,31,250200,173300,76900,Tuesday,NH,W,WWW
Christ College ATM,23-03-2011,55,38,17,237200,196700,40500,Wednesday,NH,W,WWW
Christ College ATM,24-03-2011,61,35,26,304000,184000,120000,Thursday,NH,W,WWW
Christ College ATM,25-03-2011,52,40,12,206500,185600,20900,Friday,NH,W,WWH
Christ College ATM,26-03-2011,62,35,27,215100,160500,54600,Saturday,NH,H,WHH
Christ College ATM,27-03-2011,58,34,24,286200,167000,119200,Sunday,NH,H,HHW
Christ College ATM,28-03-2011,72,48,24,263600,226900,36700,Monday,NH,W,HWW
Christ College ATM,29-03-2011,80,39,41,298000,208800,89200,Tuesday,NH,W,WWW
Christ College ATM,30-03-2011,100,43,57,399600,217700,181900,Wednesday,NH,W,WWW
Christ College ATM,31-03-2011,96,53,43,514200,374100,140100,Thursday,NH,W,WWW
Christ College ATM,01-04-2011,75,29,46,336600,195200,141400,Friday,NH,W,WWH
Christ College ATM,02-04-2011,71,33,38,285100,147000,138100,Saturday,NH,H,WHH
Christ College ATM,03-04-2011,82,23,59,333000,109600,223400,Sunday,NH,H,HHW
Christ College ATM,04-04-2011,71,35,36,295600,145700,149900,Monday,H,W,HWW
Christ College ATM,05-04-2011,99,53,46,423500,246500,177000,Tuesday,NH,W,WWW
Christ College ATM,06-04-2011,106,40,66,388700,161000,227700,Wednesday,NH,W,WWW
Christ College ATM,07-04-2011,86,50,36,388600,211200,177400,Thursday,NH,W,WWW
Christ College ATM,08-04-2011,95,48,47,373000,187600,185400,Friday,NH,W,WWH
Christ College ATM,09-04-2011,91,57,34,483600,328700,154900,Saturday,NH,H,WHH
Christ College ATM,10-04-2011,58,15,43,217800,43700,174100,Sunday,NH,H,HHW
Christ College ATM,11-04-2011,78,45,33,283400,197100,86300,Monday,NH,W,HWH
Christ College ATM,12-04-2011,82,46,36,322800,204500,118300,Tuesday,H,H,WHW
Christ College ATM,13-04-2011,67,27,40,268700,119400,149300,Wednesday,NH,W,HWH
Christ College ATM,14-04-2011,39,21,18,157000,90400,66600,Thursday,N,H,WHW
Christ College ATM,15-04-2011,96,37,59,468500,196700,271800,Friday,NH,W,HWH
Christ College ATM,16-04-2011,79,35,44,297900,103000,194900,Saturday,H,H,WHH
Christ College ATM,17-04-2011,69,22,47,174500,27700,146800,Sunday,NH,H,HHW
Christ College ATM,18-04-2011,96,47,49,469100,235700,233400,Monday,NH,W,HWW
Christ College ATM,19-04-2011,81,47,34,273000,194500,78500,Tuesday,NH,W,WWW
Christ College ATM,20-04-2011,80,50,30,305700,197200,108500,Wednesday,NH,W,WWW
Christ College ATM,21-04-2011,62,40,22,165900,136100,29800,Thursday,NH,W,WWH
Christ College ATM,22-04-2011,51,11,40,173300,23700,149600,Friday,C,H,WHH
Christ College ATM,23-04-2011,75,31,44,402500,219700,182800,Saturday,NH,H,HHH
Christ College ATM,24-04-2011,52,19,33,153700,59100,94600,Sunday,NH,H,HHW
Christ College ATM,25-04-2011,44,26,18,246600,178500,68100,Monday,NH,W,HWW
Christ College ATM,26-04-2011,72,46,26,335800,230000,105800,Tuesday,NH,W,WWW
Christ College ATM,27-04-2011,73,50,23,370400,303000,67400,Wednesday,NH,W,WWW
Christ College ATM,28-04-2011,61,40,21,270500,220400,50100,Thursday,NH,W,WWW
Christ College ATM,29-04-2011,77,45,32,270700,155500,115200,Friday,NH,W,WWH
Christ College ATM,30-04-2011,65,34,31,274900,148000,126900,Saturday,NH,H,WHH
Christ College ATM,01-05-2011,52,20,32,200300,79100,121200,Sunday,N,H,HHW
Christ College ATM,02-05-2011,93,42,51,436200,228800,207400,Monday,NH,W,HWW
Christ College ATM,03-05-2011,77,48,29,365300,250900,114400,Tuesday,NH,W,WWW
Christ College ATM,04-05-2011,64,45,19,237600,183500,54100,Wednesday,NH,W,WWW
Christ College ATM,05-05-2011,82,46,36,336000,220300,115700,Thursday,NH,W,WWW
Christ College ATM,06-05-2011,106,45,61,408100,163100,245000,Friday,NH,W,WWH
Christ College ATM,07-05-2011,59,34,25,282700,164200,118500,Saturday,NH,H,WHH
Christ College ATM,08-05-2011,35,15,20,130900,71700,59200,Sunday,NH,H,HHW
Christ College ATM,09-05-2011,57,35,22,258200,187800,70400,Monday,NH,W,HWW
Christ College ATM,10-05-2011,52,36,16,260700,193900,66800,Tuesday,NH,W,WWW
Christ College ATM,11-05-2011,63,44,19,287700,228800,58900,Wednesday,NH,W,WWW
Christ College ATM,12-05-2011,57,25,32,201200,87800,113400,Thursday,NH,W,WWW
Christ College ATM,13-05-2011,42,27,15,141900,63600,78300,Friday,NH,W,WWH
Christ College ATM,14-05-2011,79,49,30,302700,190500,112200,Saturday,NH,H,WHH
Christ College ATM,15-05-2011,51,29,22,174300,80200,94100,Sunday,NH,H,HHW
Christ College ATM,16-05-2011,57,35,22,174000,124600,49400,Monday,NH,W,HWH
Christ College ATM,17-05-2011,68,43,25,267500,206000,61500,Tuesday,H,H,WHW
Christ College ATM,18-05-2011,46,32,14,150200,116700,33500,Wednesday,NH,W,HWW
Christ College ATM,19-05-2011,53,22,31,224400,116100,108300,Thursday,NH,W,WWW
Christ College ATM,20-05-2011,88,42,46,376600,219000,157600,Friday,NH,W,WWH
Christ College ATM,21-05-2011,59,31,28,160000,85000,75000,Saturday,NH,H,WHH
Christ College ATM,22-05-2011,65,23,42,221000,43600,177400,Sunday,NH,H,HHW
Christ College ATM,23-05-2011,57,35,22,201200,143400,57800,Monday,NH,W,HWW
Christ College ATM,24-05-2011,70,38,32,274600,166800,107800,Tuesday,NH,W,WWW
Christ College ATM,25-05-2011,74,38,36,309200,146100,163100,Wednesday,NH,W,WWW
Christ College ATM,26-05-2011,113,37,76,532800,141700,391100,Thursday,NH,W,WWW
Christ College ATM,27-05-2011,105,41,64,444700,138200,306500,Friday,NH,W,WWH
Christ College ATM,28-05-2011,64,35,29,300400,183100,117300,Saturday,NH,H,WHH
Christ College ATM,29-05-2011,37,19,18,170000,114500,55500,Sunday,NH,H,HHW
Christ College ATM,30-05-2011,71,44,27,355100,218200,136900,Monday,NH,W,HWW
Christ College ATM,31-05-2011,68,37,31,346600,200300,146300,Tuesday,NH,W,WWW
Christ College ATM,01-06-2011,78,40,38,261600,93700,167900,Wednesday,NH,W,WWW
Christ College ATM,02-06-2011,96,23,73,474600,152900,321700,Thursday,NH,W,WWW
Christ College ATM,03-06-2011,84,29,55,423600,174400,249200,Friday,NH,W,WWH
Christ College ATM,04-06-2011,127,52,75,554100,186300,367800,Saturday,NH,H,WHH
Christ College ATM,05-06-2011,90,23,67,392000,90000,302000,Sunday,NH,H,HHW
Christ College ATM,06-06-2011,71,35,36,264200,153000,111200,Monday,NH,W,HWW
Christ College ATM,07-06-2011,86,48,38,381700,199400,182300,Tuesday,NH,W,WWW
Christ College ATM,08-06-2011,92,40,52,399400,164400,235000,Wednesday,NH,W,WWW
Christ College ATM,09-06-2011,51,23,28,182700,84800,97900,Thursday,NH,W,WWW
Christ College ATM,10-06-2011,98,39,59,421000,139500,281500,Friday,NH,W,WWH
Christ College ATM,11-06-2011,91,28,63,341500,78200,263300,Saturday,NH,H,WHH
Christ College ATM,12-06-2011,80,22,58,254700,73500,181200,Sunday,NH,H,HHW
Christ College ATM,13-06-2011,130,53,77,406000,146200,259800,Monday,NH,W,HWW
Christ College ATM,14-06-2011,144,41,103,657200,205100,452100,Tuesday,NH,W,WWW
Christ College ATM,15-06-2011,96,44,52,378600,181400,197200,Wednesday,NH,W,WWW
Christ College ATM,16-06-2011,60,38,22,289900,212300,77600,Thursday,NH,W,WWW
Christ College ATM,17-06-2011,55,38,17,259300,167700,91600,Friday,NH,W,WWH
Christ College ATM,18-06-2011,81,51,30,248600,174000,74600,Saturday,NH,H,WHH
Christ College ATM,19-06-2011,81,34,47,292100,102600,189500,Sunday,NH,H,HHW
Christ College ATM,20-06-2011,79,49,30,370200,259100,111100,Monday,NH,W,HWW
Christ College ATM,21-06-2011,80,39,41,401100,208500,192600,Tuesday,NH,W,WWW
Christ College ATM,22-06-2011,74,45,29,351200,207000,144200,Wednesday,NH,W,WWW
Christ College ATM,23-06-2011,57,33,24,199500,135100,64400,Thursday,NH,W,WWW
Christ College ATM,24-06-2011,84,49,35,285800,143600,142200,Friday,NH,W,WWH
Christ College ATM,25-06-2011,73,40,33,299700,159600,140100,Saturday,NH,H,WHH
Christ College ATM,26-06-2011,33,19,14,87300,57000,30300,Sunday,NH,H,HHW
Christ College ATM,27-06-2011,84,45,39,339400,186700,152700,Monday,NH,W,HWW
Christ College ATM,28-06-2011,73,40,33,266300,142100,124200,Tuesday,NH,W,WWW
Christ College ATM,29-06-2011,74,51,23,247200,138000,109200,Wednesday,NH,W,WWW
Christ College ATM,30-06-2011,69,45,24,332100,227600,104500,Thursday,NH,W,WWW
Christ College ATM,01-07-2011,88,47,41,403200,182300,220900,Friday,NH,W,WWH
Christ College ATM,02-07-2011,87,37,50,421600,211400,210200,Saturday,NH,H,WHH
Christ College ATM,03-07-2011,85,24,61,325000,108500,216500,Sunday,NH,H,HHW
Christ College ATM,04-07-2011,96,43,53,442800,181000,261800,Monday,NH,W,HWW
Christ College ATM,05-07-2011,59,36,23,296100,202400,93700,Tuesday,NH,W,WWW
Christ College ATM,06-07-2011,146,69,77,723200,372800,350400,Wednesday,NH,W,WWW
Christ College ATM,07-07-2011,111,59,52,479300,235500,243800,Thursday,NH,W,WWW
Christ College ATM,08-07-2011,104,64,40,460500,289200,171300,Friday,NH,W,WWW
Christ College ATM,09-07-2011,63,41,22,312100,230300,81800,Saturday,NH,H,WHH
Christ College ATM,10-07-2011,53,30,23,224700,107600,117100,Sunday,NH,H,HHW
Christ College ATM,11-07-2011,85,46,39,310400,149500,160900,Monday,NH,W,HWW
Christ College ATM,12-07-2011,67,48,19,221200,181300,39900,Tuesday,NH,W,WWW
Christ College ATM,13-07-2011,60,45,15,219500,190200,29300,Wednesday,NH,W,WWW
Christ College ATM,14-07-2011,68,44,24,253000,167400,85600,Thursday,NH,W,WWW
Christ College ATM,15-07-2011,54,39,15,228700,162100,66600,Friday,NH,W,WWH
Christ College ATM,16-07-2011,64,38,26,305900,216100,89800,Saturday,NH,H,WHH
Christ College ATM,17-07-2011,78,49,29,305200,214800,90400,Sunday,NH,H,HHW
Christ College ATM,18-07-2011,59,31,28,222500,143000,79500,Monday,NH,W,HWW
Christ College ATM,19-07-2011,55,38,17,219300,158800,60500,Tuesday,NH,W,WWW
Christ College ATM,20-07-2011,58,36,22,225400,159700,65700,Wednesday,NH,W,WWW
Christ College ATM,21-07-2011,96,52,44,395600,211200,184400,Thursday,NH,W,WWW
Christ College ATM,22-07-2011,71,40,31,331400,226700,104700,Friday,NH,W,WWH
Christ College ATM,23-07-2011,92,56,36,333400,245700,87700,Saturday,NH,H,WHH
Christ College ATM,24-07-2011,73,16,57,213000,53900,159100,Sunday,NH,H,HHW
Christ College ATM,25-07-2011,61,31,30,238600,121400,117200,Monday,NH,W,HWW
Christ College ATM,26-07-2011,30,21,9,116500,89600,26900,Tuesday,NH,W,WWW
Christ College ATM,27-07-2011,62,42,20,173200,132100,41100,Wednesday,NH,W,WWW
Christ College ATM,28-07-2011,66,34,32,221500,138600,82900,Thursday,NH,W,WWW
Christ College ATM,29-07-2011,80,50,30,341200,213100,128100,Friday,NH,W,WWH
Christ College ATM,30-07-2011,109,51,58,424900,199800,225100,Saturday,NH,H,WHH
Christ College ATM,31-07-2011,58,27,31,228300,102500,125800,Sunday,NH,H,HHW
Christ College ATM,01-08-2011,74,39,35,316000,172300,143700,Monday,NH,W,HWW
Christ College ATM,02-08-2011,88,40,48,359200,139700,219500,Tuesday,NH,W,WWW
Christ College ATM,03-08-2011,53,23,30,184900,86500,98400,Wednesday,NH,W,WWW
Christ College ATM,04-08-2011,87,57,30,417700,291200,126500,Thursday,NH,W,WWW
Christ College ATM,05-08-2011,76,51,25,328300,238400,89900,Friday,NH,W,WWH
Christ College ATM,06-08-2011,130,71,59,564500,361500,203000,Saturday,NH,H,WHH
Christ College ATM,07-08-2011,71,45,26,310900,222800,88100,Sunday,NH,H,HHW
Christ College ATM,08-08-2011,73,40,33,258100,138100,120000,Monday,NH,W,HWW
Christ College ATM,09-08-2011,69,29,40,215300,98600,116700,Tuesday,NH,W,WWW
Christ College ATM,10-08-2011,92,62,30,430700,286200,144500,Wednesday,NH,W,WWW
Christ College ATM,11-08-2011,75,46,29,424600,286400,138200,Thursday,NH,W,WWW
Christ College ATM,12-08-2011,84,46,38,369900,230100,139800,Friday,NH,W,WWH
Christ College ATM,13-08-2011,66,32,34,273400,168900,104500,Saturday,NH,H,WHH
Christ College ATM,14-08-2011,55,31,24,217700,125500,92200,Sunday,NH,H,HHH
Christ College ATM,15-08-2011,28,16,12,95200,53100,42100,Monday,N,H,HHW
Christ College ATM,16-08-2011,79,54,25,294700,216900,77800,Tuesday,NH,W,HWW
Christ College ATM,17-08-2011,55,31,24,251600,142700,108900,Wednesday,NH,W,WWW
Christ College ATM,18-08-2011,60,40,20,255600,211300,44300,Thursday,NH,W,WWW
Christ College ATM,19-08-2011,59,33,26,215600,152600,63000,Friday,NH,W,WWH
Christ College ATM,20-08-2011,70,41,29,319300,219600,99700,Saturday,NH,H,WHH
Christ College ATM,21-08-2011,60,34,26,220700,142400,78300,Sunday,H,H,HHW
Christ College ATM,22-08-2011,75,47,28,389400,248900,140500,Monday,NH,W,HWW
Christ College ATM,23-08-2011,70,48,22,194600,167000,27600,Tuesday,NH,W,WWW
Christ College ATM,24-08-2011,61,39,22,204500,143000,61500,Wednesday,NH,W,WWW
Christ College ATM,25-08-2011,75,34,41,233300,133400,99900,Thursday,NH,W,WWW
Christ College ATM,26-08-2011,74,42,32,286400,201200,85200,Friday,NH,W,WWH
Christ College ATM,27-08-2011,103,39,64,341000,173600,167400,Saturday,NH,H,WHH
Christ College ATM,28-08-2011,79,31,48,259600,107300,152300,Sunday,NH,H,HHW
Christ College ATM,29-08-2011,127,49,78,444000,147900,296100,Monday,NH,W,HWW
Christ College ATM,30-08-2011,132,49,83,436400,202400,234000,Tuesday,NH,W,WHH
Christ College ATM,31-08-2011,125,38,87,561000,208600,352400,Wednesday,M,H,WHH
Christ College ATM,01-09-2011,40,23,17,170600,86500,84100,Thursday,H,H,HHW
Christ College ATM,02-09-2011,71,50,21,280100,173300,106800,Friday,NH,W,HWH
Christ College ATM,03-09-2011,96,53,43,467100,321200,145900,Saturday,NH,H,WHH
Christ College ATM,04-09-2011,65,34,31,328700,202900,125800,Sunday,NH,H,HHW
Christ College ATM,05-09-2011,106,71,35,542500,371900,170600,Monday,NH,W,HWW
Christ College ATM,06-09-2011,116,67,49,476200,244500,231700,Tuesday,NH,W,WWW
Christ College ATM,07-09-2011,72,45,27,359700,270900,88800,Wednesday,NH,W,WWW
Christ College ATM,08-09-2011,79,44,35,345200,211700,133500,Thursday,NH,W,WWW
Christ College ATM,09-09-2011,112,39,73,369400,156400,213000,Friday,NH,W,WWW
Christ College ATM,10-09-2011,87,49,38,393600,245700,147900,Saturday,NH,H,WHH
Christ College ATM,11-09-2011,49,25,24,141100,82800,58300,Sunday,NH,H,HHW
Christ College ATM,12-09-2011,50,31,19,154400,104200,50200,Monday,NH,W,HWW
Christ College ATM,13-09-2011,63,49,14,247800,198600,49200,Tuesday,NH,W,WWW
Christ College ATM,14-09-2011,65,46,19,296200,219100,77100,Wednesday,NH,W,WWW
Christ College ATM,15-09-2011,82,38,44,326900,171600,155300,Thursday,NH,W,WWW
Christ College ATM,16-09-2011,74,40,34,370100,233200,136900,Friday,NH,W,WWH
Christ College ATM,17-09-2011,75,42,33,257500,145600,111900,Saturday,NH,H,WHH
Christ College ATM,18-09-2011,51,32,19,196500,109800,86700,Sunday,NH,H,HHW
Christ College ATM,19-09-2011,53,36,17,214300,159500,54800,Monday,NH,W,HWW
Christ College ATM,20-09-2011,70,39,31,293200,181200,112000,Tuesday,NH,W,WWW
Christ College ATM,21-09-2011,84,44,40,282200,157400,124800,Wednesday,NH,W,WWW
Christ College ATM,22-09-2011,66,42,24,257700,187300,70400,Thursday,NH,W,WWW
Christ College ATM,23-09-2011,74,44,30,323300,220600,102700,Friday,NH,W,WWH
Christ College ATM,24-09-2011,84,54,30,304900,228300,76600,Saturday,NH,H,WHH
Christ College ATM,25-09-2011,45,21,24,168800,89700,79100,Sunday,NH,H,HHW
Christ College ATM,26-09-2011,58,28,30,186600,69200,117400,Monday,NH,W,HWW
Christ College ATM,27-09-2011,52,31,21,174500,113700,60800,Tuesday,NH,W,WWW
Christ College ATM,28-09-2011,72,37,35,233600,130700,102900,Wednesday,NH,W,WWW
Christ College ATM,29-09-2011,96,42,54,438400,205000,233400,Thursday,NH,W,WWW
Christ College ATM,30-09-2011,65,38,27,275100,206500,68600,Friday,NH,W,WWH
Christ College ATM,01-10-2011,100,34,66,376100,126300,249800,Saturday,NH,H,WHH
Christ College ATM,02-10-2011,80,20,60,263000,81900,181100,Sunday,N,H,HHW
Christ College ATM,03-10-2011,37,22,15,178100,106900,71200,Monday,NH,W,HWW
Christ College ATM,04-10-2011,67,40,27,265500,152200,113300,Tuesday,NH,W,WWH
Christ College ATM,05-10-2011,36,17,19,123600,69100,54500,Wednesday,H,H,WHH
Christ College ATM,06-10-2011,74,46,28,356100,240800,115300,Thursday,H,H,HHW
Christ College ATM,07-10-2011,86,54,32,360000,228600,131400,Friday,NH,W,WWH
Christ College ATM,08-10-2011,110,80,30,582300,455000,127300,Saturday,NH,H,WHH
Christ College ATM,09-10-2011,54,24,30,191800,89000,102800,Sunday,NH,H,HHW
Christ College ATM,10-10-2011,131,74,57,590500,359100,231400,Monday,NH,W,HWW
Christ College ATM,11-10-2011,83,57,26,423700,313900,109800,Tuesday,NH,W,WWW
Christ College ATM,12-10-2011,86,63,23,474500,394800,79700,Wednesday,NH,W,WWW
Christ College ATM,13-10-2011,75,45,30,297200,185300,111900,Thursday,NH,W,WWW
Christ College ATM,14-10-2011,55,35,20,234600,159300,75300,Friday,NH,W,WWH
Christ College ATM,15-10-2011,98,46,52,436600,231400,205200,Saturday,NH,H,WHH
Christ College ATM,16-10-2011,59,24,35,206600,86100,120500,Sunday,NH,H,HHW
Christ College ATM,17-10-2011,41,20,21,130300,62400,67900,Monday,NH,W,HWW
Christ College ATM,18-10-2011,112,44,68,473900,239700,234200,Tuesday,NH,W,WWW
Christ College ATM,19-10-2011,90,51,39,298800,184400,114400,Wednesday,NH,W,WWW
Christ College ATM,20-10-2011,132,56,76,681500,378500,303000,Thursday,NH,W,WWW
Christ College ATM,21-10-2011,104,36,68,433800,202500,231300,Friday,NH,W,WWH
Christ College ATM,22-10-2011,204,61,143,781500,277500,504000,Saturday,NH,H,WHH
Christ College ATM,23-10-2011,99,36,63,380700,181100,199600,Sunday,NH,H,HHW
Christ College ATM,24-10-2011,134,50,84,490400,255100,235300,Monday,NH,W,HWW
Christ College ATM,25-10-2011,100,56,44,424600,292400,132200,Tuesday,NH,W,WWH
Christ College ATM,26-10-2011,24,14,10,59900,30500,29400,Wednesday,H,H,WHW
Christ College ATM,27-10-2011,55,40,15,216400,177200,39200,Thursday,NH,W,HWW
Christ College ATM,28-10-2011,54,34,20,189000,116700,72300,Friday,NH,W,WWH
Christ College ATM,29-10-2011,56,38,18,237900,167900,70000,Saturday,NH,H,WHH
Christ College ATM,30-10-2011,42,18,24,105500,36700,68800,Sunday,NH,H,HHW
Christ College ATM,31-10-2011,58,37,21,263900,183100,80800,Monday,NH,W,HWW
Christ College ATM,01-11-2011,90,62,28,397000,278800,118200,Tuesday,NH,W,WWW
Christ College ATM,02-11-2011,97,39,58,417400,129900,287500,Wednesday,NH,W,WWW
Christ College ATM,03-11-2011,110,49,61,473000,173500,299500,Thursday,NH,W,WWW
Christ College ATM,04-11-2011,93,70,23,463400,329600,133800,Friday,NH,W,WWH
Christ College ATM,05-11-2011,122,79,43,484500,286100,198400,Saturday,NH,H,WHH
Christ College ATM,06-11-2011,83,32,51,326100,161900,164200,Sunday,NH,H,HHH
Christ College ATM,07-11-2011,56,33,23,161400,92500,68900,Monday,M,H,HHW
Christ College ATM,08-11-2011,97,43,54,442500,170500,272000,Tuesday,NH,W,HWW
Christ College ATM,09-11-2011,101,41,60,412700,201100,211600,Wednesday,NH,W,WWW
Christ College ATM,10-11-2011,81,46,35,319000,220700,98300,Thursday,NH,W,WWW
Christ College ATM,11-11-2011,97,42,55,412300,190000,222300,Friday,NH,W,WWH
Christ College ATM,12-11-2011,76,48,28,351100,222600,128500,Saturday,NH,H,WHH
Christ College ATM,13-11-2011,71,38,33,218200,125700,92500,Sunday,NH,H,HHW
Christ College ATM,14-11-2011,75,38,37,359900,212700,147200,Monday,NH,W,HWW
Christ College ATM,15-11-2011,96,50,46,421300,235200,186100,Tuesday,NH,W,WWW
Christ College ATM,16-11-2011,64,33,31,243700,167500,76200,Wednesday,NH,W,WWW
Christ College ATM,17-11-2011,88,56,32,355800,260600,95200,Thursday,NH,W,WWW
Christ College ATM,18-11-2011,61,35,26,204700,139400,65300,Friday,NH,W,WWH
Christ College ATM,19-11-2011,83,54,29,346900,278200,68700,Saturday,NH,H,WHH
Christ College ATM,20-11-2011,54,29,25,153700,70600,83100,Sunday,NH,H,HHW
Christ College ATM,21-11-2011,68,38,30,225500,109300,116200,Monday,NH,W,HWW
Christ College ATM,22-11-2011,81,46,35,351500,219000,132500,Tuesday,NH,W,WWW
Christ College ATM,23-11-2011,71,42,29,247800,156400,91400,Wednesday,NH,W,WWW
Christ College ATM,24-11-2011,72,44,28,268100,186200,81900,Thursday,NH,W,WWW
Christ College ATM,25-11-2011,62,36,26,240300,175400,64900,Friday,NH,W,WWH
Christ College ATM,26-11-2011,60,39,21,283300,214500,68800,Saturday,NH,H,WHH
Christ College ATM,27-11-2011,42,27,15,123000,85700,37300,Sunday,NH,H,HHW
Christ College ATM,28-11-2011,79,42,37,298300,145000,153300,Monday,NH,W,HWW
Christ College ATM,29-11-2011,91,57,34,458900,321700,137200,Tuesday,NH,W,WWW
Christ College ATM,30-11-2011,71,38,33,340400,203000,137400,Wednesday,NH,W,WWW
Christ College ATM,01-12-2011,86,38,48,411900,193700,218200,Thursday,NH,W,WWW
Christ College ATM,02-12-2011,83,52,31,365500,236100,129400,Friday,NH,W,WWH
Christ College ATM,03-12-2011,111,76,35,527700,345300,182400,Saturday,NH,H,WHH
Christ College ATM,04-12-2011,71,39,32,294800,195300,99500,Sunday,NH,H,HHW
Christ College ATM,05-12-2011,93,49,44,429600,236800,192800,Monday,NH,W,HWH
Christ College ATM,06-12-2011,95,40,55,420800,183700,237100,Tuesday,M,H,WHW
Christ College ATM,07-12-2011,107,56,51,493300,274800,218500,Wednesday,NH,W,HWW
Christ College ATM,08-12-2011,78,43,35,356500,189200,167300,Thursday,NH,W,WWW
Christ College ATM,09-12-2011,98,54,44,414700,257600,157100,Friday,NH,W,WWH
Christ College ATM,10-12-2011,100,55,45,384600,210600,174000,Saturday,NH,H,WHH
Christ College ATM,11-12-2011,41,13,28,131400,48400,83000,Sunday,NH,H,HHW
Christ College ATM,12-12-2011,82,42,40,329000,182500,146500,Monday,NH,W,HWW
Christ College ATM,13-12-2011,97,54,43,398600,275500,123100,Tuesday,NH,W,WWW
Christ College ATM,14-12-2011,72,54,18,281900,231500,50400,Wednesday,NH,W,WWW
Christ College ATM,15-12-2011,77,56,21,319100,270400,48700,Thursday,NH,W,WWW
Christ College ATM,16-12-2011,72,31,41,279600,111400,168200,Friday,NH,W,WWH
Christ College ATM,17-12-2011,62,44,18,279300,212200,67100,Saturday,NH,H,WHH
Christ College ATM,18-12-2011,44,26,18,184300,128800,55500,Sunday,NH,H,HHW
Christ College ATM,19-12-2011,60,32,28,183500,116000,67500,Monday,NH,W,HWW
Christ College ATM,20-12-2011,52,31,21,178600,125400,53200,Tuesday,NH,W,WWW
Christ College ATM,21-12-2011,76,57,19,343100,278000,65100,Wednesday,NH,W,WWW
Christ College ATM,22-12-2011,42,29,13,142900,117900,25000,Thursday,NH,W,WWW
Christ College ATM,23-12-2011,88,41,47,321100,198700,122400,Friday,NH,W,WWH
Christ College ATM,24-12-2011,90,51,39,356700,253100,103600,Saturday,NH,H,WHH
Christ College ATM,25-12-2011,61,39,22,254600,213400,41200,Sunday,C,H,HHW
Christ College ATM,26-12-2011,80,37,43,355800,183700,172100,Monday,NH,W,HWW
Christ College ATM,27-12-2011,65,30,35,232500,112800,119700,Tuesday,NH,W,WWW
Christ College ATM,28-12-2011,75,32,43,279900,99400,180500,Wednesday,NH,W,WWW
Christ College ATM,29-12-2011,63,34,29,334300,196800,137500,Thursday,NH,W,WWW
Christ College ATM,30-12-2011,61,35,26,336200,258700,77500,Friday,NH,W,WWH
Christ College ATM,31-12-2011,117,52,65,549000,289100,259900,Saturday,NH,H,WHH
Christ College ATM,01-01-2012,103,33,70,356200,123300,232900,SUNDAY,C,H,HHW
Christ College ATM,02-01-2012,127,65,62,559700,314400,245300,SUNDAY,C,H,HHW
Christ College ATM,03-01-2012,127,66,61,557100,315800,241300,SUNDAY,C,H,HHW
Christ College ATM,04-01-2012,105,47,58,430500,195200,235300,SUNDAY,C,H,HHW
Christ College ATM,05-01-2012,92,45,47,408000,224900,183100,SUNDAY,C,H,HHW
Christ College ATM,06-01-2012,148,67,81,592900,304800,288100,SUNDAY,C,H,HHW
Christ College ATM,07-01-2012,132,49,83,656600,245300,411300,SATURDAY,NH,H,WHH
Christ College ATM,08-01-2012,90,32,58,317000,149100,167900,SUNDAY,NH,H,HHW
Christ College ATM,09-01-2012,122,59,63,569900,291200,278700,SUNDAY,NH,H,HHW
Christ College ATM,10-01-2012,121,64,57,593300,337400,255900,SUNDAY,NH,H,HHW
Christ College ATM,11-01-2012,102,54,48,412400,219700,192700,SUNDAY,NH,H,HHW
Christ College ATM,12-01-2012,117,60,57,524500,259200,265300,SUNDAY,NH,H,HHW
Christ College ATM,13-01-2012,96,51,45,538100,343800,194300,SUNDAY,NH,H,HHW
Christ College ATM,14-01-2012,131,72,59,623900,411700,212200,SATURDAY,NH,H,WHH
Christ College ATM,15-01-2012,68,33,35,225700,147400,78300,SUNDAY,H,H,HHH
Christ College ATM,16-01-2012,32,17,15,114700,78900,35800,MONDAY,H,H,HHH
Christ College ATM,17-01-2012,65,23,42,194800,66800,128000,TUESDAY,H,H,HHW
Christ College ATM,18-01-2012,101,65,36,537600,379300,158300,TUESDAY,H,H,HHW
Christ College ATM,19-01-2012,101,60,41,402700,239500,163200,TUESDAY,H,H,HHW
Christ College ATM,20-01-2012,90,45,45,392300,245300,147000,TUESDAY,H,H,HHW
Christ College ATM,21-01-2012,109,55,54,481500,277100,204400,SATURDAY,NH,H,WHH
Christ College ATM,22-01-2012,161,46,115,440500,115900,324600,SUNDAY,NH,H,HHW
Christ College ATM,23-01-2012,101,45,56,321500,146300,175200,SUNDAY,NH,H,HHW
Christ College ATM,24-01-2012,79,51,28,341200,251800,89400,SUNDAY,NH,H,HHW
Christ College ATM,25-01-2012,81,52,29,370800,254700,116100,SUNDAY,NH,H,HHW
Christ College ATM,26-01-2012,83,46,37,308700,173500,135200,THURSDAY,N,H,WHW
Christ College ATM,27-01-2012,87,49,38,484300,294600,189700,THURSDAY,N,H,WHW
Christ College ATM,28-01-2012,113,49,64,477400,217200,260200,SATURDAY,NH,H,WHH
Christ College ATM,29-01-2012,111,44,67,429300,211900,217400,SUNDAY,NH,H,HHW
Christ College ATM,30-01-2012,97,50,47,469200,231200,238000,SUNDAY,NH,H,HHW
Christ College ATM,31-01-2012,86,57,29,376100,312400,63700,SUNDAY,NH,H,HHW
Christ College ATM,01-02-2012,114,50,64,499600,179800,319800,SUNDAY,NH,H,HHW
Christ College ATM,02-02-2012,72,33,39,397300,187800,209500,SUNDAY,NH,H,HHW
Christ College ATM,03-02-2012,116,53,63,547200,281100,266100,SUNDAY,NH,H,HHW
Christ College ATM,04-02-2012,132,61,71,632400,353800,278600,SATURDAY,NH,H,WHH
Christ College ATM,05-02-2012,67,33,34,279600,146700,132900,SUNDAY,M,H,HHW
Christ College ATM,06-02-2012,116,59,57,511300,294700,216600,SUNDAY,M,H,HHW
Christ College ATM,07-02-2012,129,60,69,591400,352300,239100,SUNDAY,M,H,HHW
Christ College ATM,08-02-2012,125,50,75,594600,269200,325400,SUNDAY,M,H,HHW
Christ College ATM,09-02-2012,118,37,81,428300,132500,295800,SUNDAY,M,H,HHW
Christ College ATM,10-02-2012,157,61,96,694700,323800,370900,SUNDAY,M,H,HHW
Christ College ATM,11-02-2012,101,53,48,482100,339600,142500,SATURDAY,NH,H,WHH
Christ College ATM,12-02-2012,71,36,35,258900,180300,78600,SUNDAY,NH,H,HHW
Christ College ATM,13-02-2012,116,58,58,581400,351300,230100,SUNDAY,NH,H,HHW
Christ College ATM,14-02-2012,92,40,52,263500,128600,134900,SUNDAY,NH,H,HHW
Christ College ATM,15-02-2012,105,45,60,362200,192800,169400,SUNDAY,NH,H,HHW
Christ College ATM,16-02-2012,54,27,27,212600,151300,61300,SUNDAY,NH,H,HHW
Christ College ATM,17-02-2012,66,38,28,358600,292800,65800,SUNDAY,NH,H,HHW
Christ College ATM,18-02-2012,90,51,39,399600,262800,136800,SATURDAY,NH,H,WHH
Christ College ATM,19-02-2012,70,25,45,225200,72800,152400,SUNDAY,NH,H,HHW
Christ College ATM,20-02-2012,127,41,86,503400,169400,334000,SUNDAY,NH,H,HHW
Christ College ATM,21-02-2012,97,44,53,345900,179200,166700,SUNDAY,NH,H,HHW
Christ College ATM,22-02-2012,113,60,53,506800,300000,206800,SUNDAY,NH,H,HHW
Christ College ATM,23-02-2012,114,76,38,613900,504900,109000,SUNDAY,NH,H,HHW
Christ College ATM,24-02-2012,101,59,42,362000,255600,106400,SUNDAY,NH,H,HHW
Christ College ATM,25-02-2012,93,55,38,456000,318900,137100,SATURDAY,NH,H,WHH
Christ College ATM,26-02-2012,60,28,32,179400,104000,75400,SUNDAY,NH,H,HHW
Christ College ATM,27-02-2012,73,42,31,360300,234500,125800,SUNDAY,NH,H,HHW
Christ College ATM,28-02-2012,83,40,43,298700,179500,119200,SUNDAY,NH,H,HHW
Christ College ATM,29-02-2012,96,54,42,367000,201800,165200,SUNDAY,NH,H,HHW
Christ College ATM,01-03-2012,74,39,35,386800,222000,164800,SUNDAY,NH,H,HHW
Christ College ATM,02-03-2012,99,52,47,483200,256100,227100,SUNDAY,NH,H,HHW
Christ College ATM,03-03-2012,95,38,57,428900,152000,276900,SATURDAY,NH,H,WHH
Christ College ATM,04-03-2012,74,26,48,315500,90900,224600,SUNDAY,NH,H,HHW
Christ College ATM,05-03-2012,176,74,102,928400,486800,441600,SUNDAY,NH,H,HHW
Christ College ATM,06-03-2012,110,54,56,501000,278600,222400,SUNDAY,NH,H,HHW
Christ College ATM,07-03-2012,117,50,67,600100,305900,294200,SUNDAY,NH,H,HHW
Christ College ATM,08-03-2012,108,62,46,457000,292300,164700,SUNDAY,NH,H,HHW
Christ College ATM,09-03-2012,83,34,49,362800,191700,171100,SUNDAY,NH,H,HHW
Christ College ATM,10-03-2012,94,51,43,461200,288500,172700,SATURDAY,NH,H,WHH
Christ College ATM,11-03-2012,62,25,37,235000,96600,138400,SUNDAY,NH,H,HHW
Christ College ATM,12-03-2012,97,42,55,420500,165300,255200,SUNDAY,NH,H,HHW
Christ College ATM,13-03-2012,112,42,70,452200,220000,232200,SUNDAY,NH,H,HHW
Christ College ATM,14-03-2012,104,39,65,401300,174800,226500,SUNDAY,NH,H,HHW
Christ College ATM,15-03-2012,105,56,49,451600,303600,148000,SUNDAY,NH,H,HHW
Christ College ATM,16-03-2012,111,54,57,408700,220800,187900,SUNDAY,NH,H,HHW
Christ College ATM,17-03-2012,105,57,48,588800,365500,223300,SATURDAY,NH,H,WHH
Christ College ATM,18-03-2012,91,38,53,271300,150500,120800,SUNDAY,NH,H,HHW
Christ College ATM,19-03-2012,140,78,62,652400,459400,193000,SUNDAY,NH,H,HHW
Christ College ATM,20-03-2012,108,49,59,449000,304300,144700,SUNDAY,NH,H,HHW
Christ College ATM,21-03-2012,137,68,69,557800,376200,181600,SUNDAY,NH,H,HHW
Christ College ATM,22-03-2012,109,61,48,495600,356300,139300,SUNDAY,NH,H,HHW
Christ College ATM,23-03-2012,79,33,46,368200,239600,128600,FRIDAY,H,H,WHH
Christ College ATM,24-03-2012,98,50,48,451800,269400,182400,SATURDAY,NH,H,HHH
Christ College ATM,25-03-2012,84,36,48,317600,174100,143500,SUNDAY,NH,H,HHW
Christ College ATM,26-03-2012,108,63,45,614400,368900,245500,SUNDAY,NH,H,HHW
Christ College ATM,27-03-2012,97,46,51,387500,202500,185000,SUNDAY,NH,H,HHW
Christ College ATM,28-03-2012,95,60,35,441500,339800,101700,SUNDAY,NH,H,HHW
Christ College ATM,29-03-2012,89,51,38,378500,244900,133600,SUNDAY,NH,H,HHW
Christ College ATM,30-03-2012,100,61,39,459000,326300,132700,SUNDAY,NH,H,HHW
Christ College ATM,31-03-2012,104,71,33,505000,398700,106300,SATURDAY,NH,H,WHH
Christ College ATM,01-04-2012,96,43,53,511100,257600,253500,SUNDAY,NH,H,HHW
Christ College ATM,02-04-2012,108,32,76,358300,106500,251800,SUNDAY,NH,H,HHW
Christ College ATM,03-04-2012,143,66,77,647100,381700,265400,SUNDAY,NH,H,HHW
Christ College ATM,04-04-2012,95,52,43,500000,280900,219100,SUNDAY,NH,H,HHW
Christ College ATM,05-04-2012,69,32,37,273700,132100,141600,THURSDAY,H,H,WHH
Christ College ATM,06-04-2012,44,25,19,216200,117200,99000,FRIDAY,C,H,HHH
Christ College ATM,07-04-2012,81,66,15,447700,391100,56600,SATURDAY,NH,H,HHH
Christ College ATM,08-04-2012,60,42,18,457200,363700,93500,SUNDAY,NH,H,HHW
Christ College ATM,09-04-2012,95,77,18,494100,420200,73900,SUNDAY,NH,H,HHW
Christ College ATM,10-04-2012,89,58,31,444200,353000,91200,SUNDAY,NH,H,HHW
Christ College ATM,11-04-2012,72,52,20,412400,332800,79600,SUNDAY,NH,H,HHW
Christ College ATM,12-04-2012,60,46,14,291500,250100,41400,SUNDAY,NH,H,HHW
Christ College ATM,13-04-2012,76,40,36,431900,264000,167900,FRIDAY,H,H,WHH
Christ College ATM,14-04-2012,64,53,11,424500,385900,38600,SATURDAY,NH,H,HHH
Christ College ATM,15-04-2012,51,33,18,324000,257000,67000,SUNDAY,NH,H,HHW
Christ College ATM,16-04-2012,46,30,16,177500,129900,47600,SUNDAY,NH,H,HHW
Christ College ATM,17-04-2012,30,18,12,177300,132800,44500,SUNDAY,NH,H,HHW
Christ College ATM,18-04-2012,30,24,6,177500,154700,22800,SUNDAY,NH,H,HHW
Christ College ATM,19-04-2012,109,66,43,540800,399300,141500,SUNDAY,NH,H,HHW
Christ College ATM,20-04-2012,110,52,58,531200,366100,165100,SUNDAY,NH,H,HHW
Christ College ATM,21-04-2012,112,48,64,587100,331500,255600,SATURDAY,NH,H,WHH
Christ College ATM,22-04-2012,59,29,30,227100,110200,116900,SUNDAY,NH,H,HHW
Christ College ATM,23-04-2012,34,22,12,122200,107900,14300,SUNDAY,NH,H,HHW
Christ College ATM,24-04-2012,3,3,0,42700,42700,0,SUNDAY,NH,H,HHW
Christ College ATM,25-04-2012,18,12,6,36100,24900,11200,SUNDAY,NH,H,HHW
Christ College ATM,26-04-2012,58,37,21,266600,190800,75800,SUNDAY,NH,H,HHW
Christ College ATM,27-04-2012,71,36,35,337000,215000,122000,SUNDAY,NH,H,HHW
Christ College ATM,28-04-2012,88,60,28,408400,302400,106000,SATURDAY,NH,H,WHH
Christ College ATM,29-04-2012,26,18,8,95700,83700,12000,SUNDAY,NH,H,HHW
Christ College ATM,30-04-2012,68,38,30,255600,185300,70300,SUNDAY,NH,H,HHW
Christ College ATM,01-05-2012,42,24,18,252900,218800,34100,TUESDAY,N,H,WHW
Christ College ATM,02-05-2012,73,56,17,428300,340200,88100,TUESDAY,N,H,WHW
Christ College ATM,03-05-2012,59,44,15,344800,284200,60600,TUESDAY,N,H,WHW
Christ College ATM,04-05-2012,63,57,6,345400,308600,36800,TUESDAY,N,H,WHW
Christ College ATM,05-05-2012,62,56,6,394700,373800,20900,SATURDAY,NH,H,WHH
Christ College ATM,06-05-2012,39,32,7,219200,200100,19100,SUNDAY,NH,H,HHW
Christ College ATM,07-05-2012,87,85,2,536000,534400,1600,SUNDAY,NH,H,HHW
Christ College ATM,08-05-2012,95,47,48,489900,339000,150900,SUNDAY,NH,H,HHW
Christ College ATM,09-05-2012,67,38,29,396700,243200,153500,SUNDAY,NH,H,HHW
Christ College ATM,10-05-2012,46,31,15,230800,159200,71600,SUNDAY,NH,H,HHW
Christ College ATM,11-05-2012,70,55,15,310000,256200,53800,SUNDAY,NH,H,HHW
Christ College ATM,12-05-2012,99,44,55,454900,222400,232500,SATURDAY,NH,H,WHH
Christ College ATM,13-05-2012,69,28,41,200500,77600,122900,SUNDAY,NH,H,HHW
Christ College ATM,14-05-2012,66,38,28,394600,316800,77800,SUNDAY,NH,H,HHW
Christ College ATM,15-05-2012,130,63,67,567300,348200,219100,SUNDAY,NH,H,HHW
Christ College ATM,16-05-2012,59,31,28,215600,144500,71100,SUNDAY,NH,H,HHW
Christ College ATM,17-05-2012,78,50,28,259200,182100,77100,SUNDAY,NH,H,HHW
Christ College ATM,18-05-2012,63,44,19,358200,273200,85000,SUNDAY,NH,H,HHW
Christ College ATM,19-05-2012,86,48,38,384000,204600,179400,SUNDAY,NH,H,HHW
Christ College ATM,20-05-2012,27,25,2,73600,70600,3000,SUNDAY,NH,H,WHH
Christ College ATM,21-05-2012,59,53,6,257700,248500,9200,MONDAY,NH,H,HHW
Christ College ATM,22-05-2012,47,39,8,214600,195300,19300,MONDAY,NH,H,HHW
Christ College ATM,23-05-2012,54,22,32,206800,99000,107800,MONDAY,NH,H,HHW
Christ College ATM,24-05-2012,68,40,28,306400,206600,99800,MONDAY,NH,H,HHW
Christ College ATM,25-05-2012,81,52,29,392200,279500,112700,MONDAY,NH,H,HHW
Christ College ATM,26-05-2012,82,55,27,408100,318700,89400,SATURDAY,NH,H,WHH
Christ College ATM,27-05-2012,68,31,37,249300,93800,155500,SUNDAY,NH,H,HHW
Christ College ATM,28-05-2012,71,37,34,276100,150700,125400,SUNDAY,NH,H,HHW
Christ College ATM,29-05-2012,98,53,45,391500,243100,148400,SUNDAY,NH,H,HHW
Christ College ATM,30-05-2012,111,40,71,466500,210300,256200,SUNDAY,NH,H,HHW
Christ College ATM,31-05-2012,79,47,32,339500,238000,101500,SUNDAY,NH,H,HHW
Christ College ATM,01-06-2012,47,37,10,306000,283000,23000,SUNDAY,NH,H,HHW
Christ College ATM,02-06-2012,70,63,7,440200,428000,12200,SATURDAY,NH,H,WHH
Christ College ATM,03-06-2012,24,21,3,107700,106900,800,SUNDAY,NH,H,HHW
Christ College ATM,04-06-2012,29,27,2,81900,80700,1200,SUNDAY,NH,H,HHW
Christ College ATM,05-06-2012,63,51,12,384100,307300,76800,SUNDAY,NH,H,HHW
Christ College ATM,06-06-2012,79,45,34,388300,234700,153600,SUNDAY,NH,H,HHW
Christ College ATM,07-06-2012,175,42,133,901400,236200,665200,SUNDAY,NH,H,HHW
Christ College ATM,08-06-2012,51,10,41,154900,12500,142400,SUNDAY,NH,H,HHW
Christ College ATM,09-06-2012,60,23,37,228600,117900,110700,SATURDAY,NH,H,WHH
Christ College ATM,10-06-2012,37,9,28,175400,115200,60200,SUNDAY,NH,H,HHW
Christ College ATM,11-06-2012,42,27,15,95900,44900,51000,SUNDAY,NH,H,HHW
Christ College ATM,12-06-2012,110,35,75,468000,130200,337800,SUNDAY,NH,H,HHW
Christ College ATM,13-06-2012,32,18,14,141900,84200,57700,SUNDAY,NH,H,HHW
Christ College ATM,14-06-2012,148,40,108,637000,188600,448400,SUNDAY,NH,H,HHW
Christ College ATM,15-06-2012,94,47,47,426500,285200,141300,SUNDAY,NH,H,HHW
Christ College ATM,16-06-2012,69,39,30,268800,173900,94900,SATURDAY,NH,H,WHH
Christ College ATM,17-06-2012,78,29,49,288200,116900,171300,SUNDAY,NH,H,HHW
Christ College ATM,18-06-2012,101,57,44,531400,340300,191100,SUNDAY,NH,H,HHW
Christ College ATM,19-06-2012,94,44,50,425300,203600,221700,SUNDAY,NH,H,HHW
Christ College ATM,20-06-2012,68,41,27,223700,161800,61900,SUNDAY,NH,H,HHW
Christ College ATM,21-06-2012,114,10,104,435700,35900,399800,SUNDAY,NH,H,HHW
Christ College ATM,22-06-2012,54,25,29,196400,84700,111700,SUNDAY,NH,H,HHW
Christ College ATM,23-06-2012,118,56,62,520400,339500,180900,SATURDAY,NH,H,WHH
Christ College ATM,24-06-2012,53,22,31,247400,102700,144700,SUNDAY,NH,H,HHW
Christ College ATM,25-06-2012,72,48,24,263700,168500,95200,SUNDAY,NH,H,HHW
Christ College ATM,26-06-2012,70,48,22,239700,180200,59500,SUNDAY,NH,H,HHW
Christ College ATM,27-06-2012,81,38,43,326500,158800,167700,SUNDAY,NH,H,HHW
Christ College ATM,28-06-2012,85,58,27,364500,273400,91100,SUNDAY,NH,H,HHW
Christ College ATM,29-06-2012,58,23,35,199100,83600,115500,SUNDAY,NH,H,HHW
Christ College ATM,30-06-2012,91,62,29,448000,315800,132200,SATURDAY,NH,H,WHH
Christ College ATM,01-07-2012,111,40,71,446800,167700,279100,SUNDAY,NH,H,HHW
Christ College ATM,02-07-2012,104,50,54,554000,301200,252800,SUNDAY,NH,H,HHW
Christ College ATM,03-07-2012,117,62,55,649700,400900,248800,SUNDAY,NH,H,HHW
Christ College ATM,04-07-2012,88,39,49,491000,204600,286400,SUNDAY,NH,H,HHW
Christ College ATM,05-07-2012,129,54,75,504000,194700,309300,SUNDAY,NH,H,HHW
Christ College ATM,06-07-2012,118,44,74,505300,166100,339200,SUNDAY,NH,H,HHW
Christ College ATM,07-07-2012,90,54,36,432100,326500,105600,SATURDAY,NH,H,WHH
Christ College ATM,08-07-2012,68,27,41,423500,134700,288800,SUNDAY,NH,H,HHW
Christ College ATM,09-07-2012,144,53,91,544200,242900,301300,SUNDAY,NH,H,HHW
Christ College ATM,10-07-2012,74,44,30,298300,183100,115200,SUNDAY,NH,H,HHW
Christ College ATM,11-07-2012,83,48,35,373500,248200,125300,SUNDAY,NH,H,HHW
Christ College ATM,12-07-2012,97,55,42,389300,240500,148800,SUNDAY,NH,H,HHW
Christ College ATM,13-07-2012,79,53,26,373200,291400,81800,SUNDAY,NH,H,HHW
Christ College ATM,14-07-2012,116,62,54,601600,421600,180000,SATURDAY,NH,H,WHH
Christ College ATM,15-07-2012,56,24,32,129500,69100,60400,SUNDAY,NH,H,HHW
Christ College ATM,16-07-2012,37,21,16,194600,138100,56500,SUNDAY,NH,H,HHW
Christ College ATM,17-07-2012,82,37,45,313500,171800,141700,SUNDAY,NH,H,HHW
Christ College ATM,18-07-2012,85,40,45,401300,208300,193000,SUNDAY,NH,H,HHW
Christ College ATM,19-07-2012,54,35,19,234300,176700,57600,SUNDAY,NH,H,HHW
Christ College ATM,20-07-2012,91,57,34,461700,329100,132600,SUNDAY,NH,H,HHW
Christ College ATM,21-07-2012,103,49,54,502200,300000,202200,SATURDAY,NH,H,WHH
Christ College ATM,22-07-2012,72,29,43,230700,148400,82300,SUNDAY,NH,H,HHW
Christ College ATM,23-07-2012,92,68,24,565800,496400,69400,SUNDAY,NH,H,HHW
Christ College ATM,24-07-2012,82,52,30,449600,348700,100900,SUNDAY,NH,H,HHW
Christ College ATM,25-07-2012,69,43,26,271400,220600,50800,SUNDAY,NH,H,HHW
Christ College ATM,26-07-2012,72,38,34,363400,196900,166500,SUNDAY,NH,H,HHW
Christ College ATM,27-07-2012,74,31,43,275500,125600,149900,SUNDAY,NH,H,HHW
Christ College ATM,28-07-2012,98,57,41,511500,330700,180800,SATURDAY,NH,H,WHH
Christ College ATM,29-07-2012,62,29,33,242500,111400,131100,SUNDAY,NH,H,HHW
Christ College ATM,30-07-2012,60,40,20,299100,243600,55500,SUNDAY,NH,H,HHW
Christ College ATM,31-07-2012,101,59,42,457100,275700,181400,SUNDAY,NH,H,HHW
Christ College ATM,01-08-2012,122,48,74,646000,252400,393600,SUNDAY,NH,H,HHW
Christ College ATM,02-08-2012,87,35,52,352700,170400,182300,SUNDAY,NH,H,HHW
Christ College ATM,03-08-2012,99,49,50,519500,265600,253900,SUNDAY,NH,H,HHW
Christ College ATM,04-08-2012,79,37,42,367400,198700,168700,SATURDAY,NH,H,WHH
Christ College ATM,05-08-2012,115,37,78,406000,160000,246000,SUNDAY,NH,H,HHW
Christ College ATM,06-08-2012,124,50,74,634900,276500,358400,SUNDAY,NH,H,HHW
Christ College ATM,07-08-2012,115,51,64,580000,336000,244000,SUNDAY,NH,H,HHW
Christ College ATM,08-08-2012,149,68,81,592800,320000,272800,SUNDAY,NH,H,HHW
Christ College ATM,09-08-2012,93,48,45,342700,219200,123500,SUNDAY,NH,H,HHW
Christ College ATM,10-08-2012,67,37,30,319300,237400,81900,SUNDAY,NH,H,HHW
Christ College ATM,11-08-2012,131,46,85,622200,245900,376300,SATURDAY,NH,H,WHH
Christ College ATM,12-08-2012,75,30,45,212100,94200,117900,SUNDAY,NH,H,HHW
Christ College ATM,13-08-2012,80,42,38,408200,218600,189600,SUNDAY,NH,H,HHW
Christ College ATM,14-08-2012,90,37,53,319800,131700,188100,SUNDAY,NH,H,HHW
Christ College ATM,15-08-2012,79,39,40,302400,163000,139400,WEDNESDAY,N,H,WHW
Christ College ATM,16-08-2012,85,53,32,448500,333900,114600,WEDNESDAY,N,H,WHW
Christ College ATM,17-08-2012,116,74,42,637800,442000,195800,WEDNESDAY,N,H,WHW
Christ College ATM,18-08-2012,100,56,44,403800,282400,121400,SATURDAY,NH,H,WHH
Christ College ATM,19-08-2012,50,18,32,157900,86200,71700,SUNDAY,NH,H,HHH
Christ College ATM,20-08-2012,67,28,39,291500,132300,159200,MONDAY,M,H,HHW
Christ College ATM,21-08-2012,95,58,37,426400,324000,102400,MONDAY,M,H,HHW
Christ College ATM,22-08-2012,82,49,33,314600,235900,78700,MONDAY,M,H,HHW
Christ College ATM,23-08-2012,93,40,53,383800,251200,132600,MONDAY,M,H,HHW
Christ College ATM,24-08-2012,111,64,47,540800,418300,122500,MONDAY,M,H,HHW
Christ College ATM,25-08-2012,99,52,47,343100,203500,139600,SATURDAY,NH,H,WHH
Christ College ATM,26-08-2012,89,29,60,243900,95900,148000,SUNDAY,NH,H,HHW
Christ College ATM,27-08-2012,95,52,43,433600,264400,169200,SUNDAY,NH,H,HHW
Christ College ATM,28-08-2012,100,41,59,418500,198300,220200,SUNDAY,NH,H,HHW
Christ College ATM,29-08-2012,91,34,57,414900,174000,240900,SUNDAY,NH,H,HHW
Christ College ATM,30-08-2012,106,39,67,412400,166700,245700,SUNDAY,NH,H,HHW
Christ College ATM,31-08-2012,110,53,57,473900,289900,184000,SUNDAY,NH,H,HHW
Christ College ATM,01-09-2012,134,64,70,768100,397200,370900,SATURDAY,NH,H,WHH
Christ College ATM,02-09-2012,136,37,99,555700,183000,372700,SUNDAY,NH,H,HHW
Christ College ATM,03-09-2012,124,58,66,554700,301800,252900,SUNDAY,NH,H,HHW
Christ College ATM,04-09-2012,114,52,62,718900,407400,311500,SUNDAY,NH,H,HHW
Christ College ATM,05-09-2012,118,58,60,648500,373300,275200,SUNDAY,NH,H,HHW
Christ College ATM,06-09-2012,113,60,53,563900,367700,196200,SUNDAY,NH,H,HHW
Christ College ATM,07-09-2012,122,64,58,556800,327200,229600,SUNDAY,NH,H,HHW
Christ College ATM,08-09-2012,128,55,73,679300,375600,303700,SATURDAY,NH,H,WHH
Christ College ATM,09-09-2012,140,35,105,430500,129500,301000,SUNDAY,NH,H,HHW
Christ College ATM,10-09-2012,108,47,61,463600,235900,227700,SUNDAY,NH,H,HHW
Christ College ATM,11-09-2012,131,40,91,654600,245700,408900,SUNDAY,NH,H,HHW
Christ College ATM,12-09-2012,123,39,84,503600,176300,327300,SUNDAY,NH,H,HHW
Christ College ATM,13-09-2012,120,61,59,569200,389700,179500,SUNDAY,NH,H,HHW
Christ College ATM,14-09-2012,97,48,49,472300,269700,202600,SUNDAY,NH,H,HHW
Christ College ATM,15-09-2012,106,58,48,441500,264900,176600,SATURDAY,NH,H,WHH
Christ College ATM,16-09-2012,129,43,86,442800,261200,181600,SUNDAY,NH,H,HHW
Christ College ATM,17-09-2012,87,35,52,337400,209600,127800,SUNDAY,NH,H,HHW
Christ College ATM,18-09-2012,109,43,66,386300,210200,176100,SUNDAY,NH,H,HHW
Christ College ATM,19-09-2012,116,33,83,368300,132800,235500,WEDNESDAY,H,H,WHW
Christ College ATM,20-09-2012,109,40,69,342400,129500,212900,WEDNESDAY,H,H,WHW
Christ College ATM,21-09-2012,144,46,98,447100,146600,300500,WEDNESDAY,H,H,WHW
Christ College ATM,22-09-2012,125,56,69,612100,333100,279000,SATURDAY,NH,H,WHH
Christ College ATM,23-09-2012,88,39,49,301200,178700,122500,SUNDAY,NH,H,HHW
Christ College ATM,24-09-2012,99,54,45,442000,283900,158100,SUNDAY,NH,H,HHW
Christ College ATM,25-09-2012,78,34,44,320300,170300,150000,SUNDAY,NH,H,HHW
Christ College ATM,26-09-2012,74,42,32,320200,221000,99200,SUNDAY,NH,H,HHW
Christ College ATM,27-09-2012,108,35,73,394800,158900,235900,SUNDAY,NH,H,HHW
Christ College ATM,28-09-2012,154,40,114,696200,248000,448200,SUNDAY,NH,H,HHW
Christ College ATM,29-09-2012,101,43,58,384400,198000,186400,SATURDAY,NH,H,WHH
Christ College ATM,30-09-2012,81,36,45,306500,191400,115100,SUNDAY,NH,H,HHW
Christ College ATM,01-10-2012,80,45,35,308000,155300,152700,SUNDAY,NH,H,HHW
Christ College ATM,02-10-2012,66,32,34,276700,142800,133900,TUESDAY,N,H,WHW
Christ College ATM,03-10-2012,215,46,169,822700,201100,621600,TUESDAY,N,H,WHW
Christ College ATM,04-10-2012,139,46,93,740800,275300,465500,TUESDAY,N,H,WHW
Christ College ATM,05-10-2012,157,52,105,719600,287100,432500,TUESDAY,N,H,WHW
Christ College ATM,06-10-2012,170,62,108,835500,343800,491700,SATURDAY,NH,H,WHH
Christ College ATM,07-10-2012,99,38,61,401500,178800,222700,SUNDAY,NH,H,HHW
Christ College ATM,08-10-2012,181,54,127,729500,260500,469000,SUNDAY,NH,H,HHW
Christ College ATM,09-10-2012,138,64,74,679300,367200,312100,SUNDAY,NH,H,HHW
Christ College ATM,10-10-2012,144,58,86,703600,268600,435000,SUNDAY,NH,H,HHW
Christ College ATM,11-10-2012,129,54,75,618400,332500,285900,SUNDAY,NH,H,HHW
Christ College ATM,12-10-2012,128,59,69,564200,356300,207900,SUNDAY,NH,H,HHW
Christ College ATM,13-10-2012,129,58,71,523800,331500,192300,SATURDAY,NH,H,WHH
Christ College ATM,14-10-2012,89,41,48,371500,232700,138800,SUNDAY,NH,H,HHW
Christ College ATM,15-10-2012,143,48,95,683300,322900,360400,SUNDAY,NH,H,HHW
Christ College ATM,16-10-2012,110,57,53,478800,300700,178100,SUNDAY,NH,H,HHW
Christ College ATM,17-10-2012,100,50,50,464500,303500,161000,SUNDAY,NH,H,HHW
Christ College ATM,18-10-2012,90,41,49,380600,238200,142400,SUNDAY,NH,H,HHW
Christ College ATM,19-10-2012,88,53,35,487800,359700,128100,SUNDAY,NH,H,HHW
Christ College ATM,20-10-2012,100,49,51,488800,306300,182500,SATURDAY,NH,H,WHH
Christ College ATM,21-10-2012,57,29,28,250400,168600,81800,SUNDAY,NH,H,HHW
Christ College ATM,22-10-2012,94,58,36,530700,424000,106700,SUNDAY,NH,H,HHW
Christ College ATM,23-10-2012,68,35,33,365700,256700,109000,TUESDAY,H,H,WHH
Christ College ATM,24-10-2012,67,45,22,256000,191500,64500,WEDNESDAY,H,H,HHW
Christ College ATM,25-10-2012,101,63,38,448300,320900,127400,WEDNESDAY,H,H,HHW
Christ College ATM,26-10-2012,56,32,24,227400,170300,57100,WEDNESDAY,H,H,HHW
Christ College ATM,27-10-2012,74,33,41,308700,188600,120100,SATURDAY,M,H,WHH
Christ College ATM,28-10-2012,97,31,66,317200,174900,142300,SUNDAY,NH,H,HHW
Christ College ATM,29-10-2012,104,37,67,343200,115000,228200,SUNDAY,NH,H,HHW
Christ College ATM,30-10-2012,99,52,47,368400,237800,130600,SUNDAY,NH,H,HHW
Christ College ATM,31-10-2012,59,21,38,321000,141300,179700,SUNDAY,NH,H,HHW
Christ College ATM,01-11-2012,112,47,65,647600,285800,361800,SUNDAY,NH,H,HHW
Christ College ATM,02-11-2012,131,31,100,548300,151700,396600,SUNDAY,NH,H,HHW
Christ College ATM,03-11-2012,141,76,65,622100,361000,261100,SATURDAY,NH,H,WHH
Christ College ATM,04-11-2012,122,45,77,558700,266800,291900,SUNDAY,NH,H,HHW
Christ College ATM,05-11-2012,165,54,111,895300,296500,598800,SUNDAY,NH,H,HHW
Christ College ATM,06-11-2012,135,72,63,578400,327800,250600,SUNDAY,NH,H,HHW
Christ College ATM,07-11-2012,208,78,130,1094800,515700,579100,SUNDAY,NH,H,HHW
Christ College ATM,08-11-2012,160,54,106,674200,290100,384100,SUNDAY,NH,H,HHW
Christ College ATM,09-11-2012,132,53,79,560900,271100,289800,SUNDAY,NH,H,HHW
Christ College ATM,10-11-2012,185,67,118,825100,356800,468300,SATURDAY,NH,H,WHH
Christ College ATM,11-11-2012,155,47,108,583700,203300,380400,SUNDAY,NH,H,HHW
Christ College ATM,12-11-2012,104,57,47,410500,285400,125100,SUNDAY,NH,H,HHW
Christ College ATM,13-11-2012,55,22,33,179800,88700,91100,TUESDAY,H,H,WHW
Christ College ATM,14-11-2012,82,42,40,267100,130100,137000,TUESDAY,H,H,WHW
Christ College ATM,15-11-2012,106,53,53,515600,294300,221300,TUESDAY,H,H,WHW
Christ College ATM,16-11-2012,98,54,44,364600,196500,168100,TUESDAY,H,H,WHW
Christ College ATM,17-11-2012,118,54,64,578800,324900,253900,SATURDAY,NH,H,WHH
Christ College ATM,18-11-2012,77,26,51,239100,80800,158300,SUNDAY,NH,H,HHW
Christ College ATM,19-11-2012,66,27,39,202500,92800,109700,SUNDAY,NH,H,HHW
Christ College ATM,20-11-2012,81,50,31,336100,236800,99300,SUNDAY,NH,H,HHW
Christ College ATM,21-11-2012,80,52,28,426700,319400,107300,SUNDAY,NH,H,HHW
Christ College ATM,22-11-2012,82,45,37,335900,252200,83700,SUNDAY,NH,H,HHW
Christ College ATM,23-11-2012,96,54,42,427800,302300,125500,SUNDAY,NH,H,HHW
Christ College ATM,24-11-2012,86,44,42,341900,259000,82900,SATURDAY,NH,H,WHH
Christ College ATM,25-11-2012,83,36,47,237700,89600,148100,SUNDAY,M,H,HHW
Christ College ATM,26-11-2012,78,49,29,359900,270800,89100,SUNDAY,M,H,HHW
Christ College ATM,27-11-2012,97,51,46,439800,267900,171900,SUNDAY,M,H,HHW
Christ College ATM,28-11-2012,97,52,45,475300,336200,139100,SUNDAY,M,H,HHW
Christ College ATM,29-11-2012,99,53,46,409600,310500,99100,SUNDAY,M,H,HHW
Christ College ATM,30-11-2012,111,49,62,511600,246500,265100,SUNDAY,M,H,HHW
Christ College ATM,01-12-2012,143,71,72,791300,462400,328900,SATURDAY,NH,H,WHH
Christ College ATM,02-12-2012,181,50,131,810600,279400,531200,SUNDAY,NH,H,HHW
Christ College ATM,03-12-2012,132,43,89,538100,174400,363700,SUNDAY,NH,H,HHW
Christ College ATM,04-12-2012,139,60,79,678500,308900,369600,SUNDAY,NH,H,HHW
Christ College ATM,05-12-2012,147,56,91,800400,360600,439800,SUNDAY,NH,H,HHW
Christ College ATM,06-12-2012,146,56,90,585300,231000,354300,SUNDAY,NH,H,HHW
Christ College ATM,07-12-2012,119,55,64,527900,304700,223200,SUNDAY,NH,H,HHW
Christ College ATM,08-12-2012,146,81,65,768900,496000,272900,SATURDAY,NH,H,WHH
Christ College ATM,09-12-2012,108,46,62,439700,201100,238600,SUNDAY,NH,H,HHW
Christ College ATM,10-12-2012,106,52,54,476500,267300,209200,SUNDAY,NH,H,HHW
Christ College ATM,11-12-2012,125,50,75,582500,253200,329300,SUNDAY,NH,H,HHW
Christ College ATM,12-12-2012,109,44,65,406900,146000,260900,SUNDAY,NH,H,HHW
Christ College ATM,13-12-2012,116,43,73,512500,195400,317100,SUNDAY,NH,H,HHW
Christ College ATM,14-12-2012,80,43,37,366100,252800,113300,SUNDAY,NH,H,HHW
Christ College ATM,15-12-2012,105,53,52,568700,376800,191900,SATURDAY,NH,H,WHH
Christ College ATM,16-12-2012,119,33,86,315200,96600,218600,SUNDAY,NH,H,HHW
Christ College ATM,17-12-2012,94,51,43,277500,138600,138900,SUNDAY,NH,H,HHW
Christ College ATM,18-12-2012,106,52,54,428800,251400,177400,SUNDAY,NH,H,HHW
Christ College ATM,19-12-2012,107,43,64,324400,176100,148300,SUNDAY,NH,H,HHW
Christ College ATM,20-12-2012,106,65,41,521500,382400,139100,SUNDAY,NH,H,HHW
Christ College ATM,21-12-2012,92,64,28,353000,294800,58200,SUNDAY,NH,H,HHW
Christ College ATM,22-12-2012,84,55,29,437200,354500,82700,SATURDAY,NH,H,WHH
Christ College ATM,23-12-2012,78,28,50,358700,152300,206400,SUNDAY,NH,H,HHW
Christ College ATM,24-12-2012,108,49,59,359600,174900,184700,SUNDAY,NH,H,HHW
Christ College ATM,25-12-2012,68,36,32,163000,100100,62900,TUESDAY,C,H,WHW
Christ College ATM,26-12-2012,105,47,58,480700,214500,266200,TUESDAY,C,H,WHW
Christ College ATM,27-12-2012,100,41,59,430300,213300,217000,TUESDAY,C,H,WHW
Christ College ATM,28-12-2012,80,41,39,244600,149600,95000,TUESDAY,C,H,WHW
Christ College ATM,29-12-2012,103,51,52,549300,282000,267300,SATURDAY,NH,H,WHH
Christ College ATM,30-12-2012,69,26,43,169600,42300,127300,SUNDAY,NH,H,HHW
Christ College ATM,31-12-2012,105,58,47,381700,261400,120300,SUNDAY,NH,H,HHW
Christ College ATM,01-01-2013,95,39,56,427100,235700,191400,TUESDAY,C,H,WHW
Christ College ATM,02-01-2013,106,40,66,452100,171800,280300,WEDNESDAY,NH,W,HWW
Christ College ATM,03-01-2013,117,66,51,671600,462900,208700,THURSDAY,NH,W,WWW
Christ College ATM,04-01-2013,143,56,87,682900,351300,331600,FRIDAY,NH,W,WHH
Christ College ATM,05-01-2013,160,66,94,748100,375500,372600,SATURDAY,NH,H,HHW
Christ College ATM,06-01-2013,65,34,31,293200,187200,106000,SUNDAY,NH,H,HWW
Christ College ATM,07-01-2013,140,56,84,763100,282000,481100,MONDAY,NH,W,WWW
Christ College ATM,08-01-2013,114,41,73,547900,239400,308500,TUESDAY,NH,W,WWW
Christ College ATM,09-01-2013,152,67,85,706900,388800,318100,WEDNESDAY,NH,W,WWW
Christ College ATM,10-01-2013,118,45,73,568900,266000,302900,THURSDAY,NH,W,WWW
Christ College ATM,11-01-2013,179,61,118,910800,360300,550500,FRIDAY,NH,W,WWH
Christ College ATM,12-01-2013,84,38,46,333000,169700,163300,SATURDAY,NH,H,HHH
Christ College ATM,13-01-2013,104,30,74,318800,90600,228200,SUNDAY,NH,H,HHH
Christ College ATM,14-01-2013,60,18,42,166000,82300,83700,MONDAY,H,H,HHH
Christ College ATM,15-01-2013,62,30,32,282700,127200,155500,TUESDAY,H,H,HHH
Christ College ATM,16-01-2013,65,36,29,152900,99800,53100,WEDNESDAY,H,H,HHW
Christ College ATM,17-01-2013,55,26,29,269100,197500,71600,THURSDAY,NH,W,HWW
Christ College ATM,18-01-2013,102,58,44,411200,270600,140600,FRIDAY,NH,W,WWH
Christ College ATM,19-01-2013,110,46,64,475300,221600,253700,SATURDAY,NH,H,WHH
Christ College ATM,20-01-2013,124,32,92,578800,141900,436900,SUNDAY,NH,H,HHW
Christ College ATM,21-01-2013,147,74,73,554000,291300,262700,MONDAY,NH,W,HWW
Christ College ATM,22-01-2013,89,52,37,369600,236200,133400,TUESDAY,NH,W,WWW
Christ College ATM,23-01-2013,97,53,44,336300,201300,135000,WEDNESDAY,NH,W,WWW
Christ College ATM,24-01-2013,102,58,44,510300,387000,123300,THURSDAY,NH,W,WWH
Christ College ATM,25-01-2013,83,45,38,263700,150300,113400,FRIDAY,M,H,WHH
Christ College ATM,26-01-2013,68,45,23,238900,173300,65600,SATURDAY,N,H,HHH
Christ College ATM,27-01-2013,85,48,37,420200,298600,121600,SUNDAY,NH,H,HHH
Christ College ATM,28-01-2013,113,41,72,568500,264500,304000,MONDAY,NH,W,HWW
Christ College ATM,29-01-2013,108,49,59,441500,231400,210100,TUESDAY,NH,W,WWW
Christ College ATM,30-01-2013,98,39,59,438900,200600,238300,WEDNESDAY,NH,W,WWW
Christ College ATM,31-01-2013,130,69,61,691300,479200,212100,THURSDAY,NH,W,WWW
Christ College ATM,01-02-2013,98,47,51,628000,362400,265600,FRIDAY,NH,W,WWH
Christ College ATM,02-02-2013,126,64,62,767000,431200,335800,SATURDAY,NH,H,WHH
Christ College ATM,03-02-2013,114,42,72,583500,234700,348800,SUNDAY,NH,H,HHW
Christ College ATM,04-02-2013,180,62,118,909100,393500,515600,MONDAY,NH,W,HWW
Christ College ATM,05-02-2013,175,56,119,800700,326900,473800,TUESDAY,NH,W,WWW
Christ College ATM,06-02-2013,172,65,107,804300,323900,480400,WEDNESDAY,NH,W,WWW
Christ College ATM,07-02-2013,89,44,45,395900,225500,170400,THURSDAY,NH,W,WWW
Christ College ATM,08-02-2013,134,53,81,675100,291000,384100,FRIDAY,NH,W,WWH
Christ College ATM,09-02-2013,116,55,61,574500,340300,234200,SATURDAY,NH,H,WHH
Christ College ATM,10-02-2013,102,49,53,333300,184100,149200,SUNDAY,NH,H,HHW
Christ College ATM,11-02-2013,115,48,67,618200,336100,282100,MONDAY,NH,W,HWW
Christ College ATM,12-02-2013,131,50,81,552000,319200,232800,TUESDAY,NH,W,WWW
Christ College ATM,13-02-2013,110,63,47,656900,466500,190400,WEDNESDAY,NH,W,WWW
Christ College ATM,14-02-2013,98,52,46,443400,274000,169400,THURSDAY,NH,W,WWW
Christ College ATM,15-02-2013,143,51,92,425000,200400,224600,FRIDAY,NH,W,WWH
Christ College ATM,16-02-2013,96,49,47,410900,279500,131400,SATURDAY,NH,H,WHH
Christ College ATM,17-02-2013,75,37,38,277400,164300,113100,SUNDAY,NH,H,HHW
Christ College ATM,18-02-2013,135,57,78,569500,297200,272300,MONDAY,NH,W,HWW
Christ College ATM,19-02-2013,134,75,59,634100,416000,218100,TUESDAY,NH,W,WWW
Christ College ATM,20-02-2013,63,34,29,237900,152500,85400,WEDNESDAY,NH,W,WWW
Christ College ATM,21-02-2013,92,54,38,436000,288800,147200,THURSDAY,NH,W,WWW
Christ College ATM,22-02-2013,89,44,45,395500,256300,139200,FRIDAY,NH,W,WWH
Christ College ATM,23-02-2013,103,44,59,504800,294900,209900,SATURDAY,NH,H,WHH
Christ College ATM,24-02-2013,78,27,51,160400,57200,103200,SUNDAY,NH,H,HHW
Christ College ATM,25-02-2013,121,69,52,532500,369100,163400,MONDAY,NH,W,HWW
Christ College ATM,26-02-2013,127,56,71,514400,199700,314700,TUESDAY,NH,W,WWW
Christ College ATM,27-02-2013,114,69,45,513900,326300,187600,WEDNESDAY,NH,W,WWW
Christ College ATM,28-02-2013,102,53,49,492000,318300,173700,THURSDAY,NH,W,WWW
Christ College ATM,01-03-2013,122,51,71,579900,306600,273300,FRIDAY,NH,W,WWH
Christ College ATM,02-03-2013,195,82,113,1229400,637000,592400,SATURDAY,NH,H,WHH
Christ College ATM,03-03-2013,119,50,69,476100,254300,221800,SUNDAY,NH,H,HHW
Christ College ATM,04-03-2013,127,61,66,620200,336000,284200,MONDAY,NH,W,HWW
Christ College ATM,05-03-2013,149,66,83,717000,354100,362900,TUESDAY,NH,W,WWW
Christ College ATM,06-03-2013,156,61,95,631300,291200,340100,WEDNESDAY,NH,W,WWW
Christ College ATM,07-03-2013,149,75,74,701400,420300,281100,THURSDAY,NH,W,WWW
Christ College ATM,08-03-2013,128,75,53,746700,520700,226000,FRIDAY,NH,W,WWH
Christ College ATM,09-03-2013,102,52,50,659100,450400,208700,SATURDAY,NH,H,WHH
Christ College ATM,10-03-2013,69,35,34,275400,176600,98800,SUNDAY,NH,H,HWW
Christ College ATM,11-03-2013,134,67,67,694400,490700,203700,MONDAY,NH,W,HWW
Christ College ATM,12-03-2013,113,59,54,455700,264200,191500,TUESDAY,NH,W,WWW
Christ College ATM,13-03-2013,86,49,37,398200,282000,116200,WEDNESDAY,NH,W,WWW
Christ College ATM,14-03-2013,95,53,42,463400,320600,142800,THURSDAY,NH,W,WWW
Christ College ATM,15-03-2013,81,49,32,359700,248800,110900,FRIDAY,NH,W,WWH
Christ College ATM,16-03-2013,107,57,50,530600,331000,199600,SATURDAY,NH,H,WHH
Christ College ATM,17-03-2013,87,37,50,293100,169800,123300,SUNDAY,NH,H,HHW
Christ College ATM,18-03-2013,114,39,75,356900,118200,238700,MONDAY,NH,W,HWW
Christ College ATM,19-03-2013,110,45,65,494600,246600,248000,TUESDAY,NH,W,WWW
Christ College ATM,20-03-2013,122,53,69,444900,251700,193200,WEDNESDAY,NH,W,WWW
Christ College ATM,21-03-2013,117,58,59,609700,437500,172200,THURSDAY,NH,W,WWW
Christ College ATM,22-03-2013,127,50,77,580100,275300,304800,FRIDAY,NH,W,WWH
Christ College ATM,23-03-2013,101,60,41,391100,247200,143900,SATURDAY,NH,H,WHH
Christ College ATM,24-03-2013,79,37,42,294400,174300,120100,SUNDAY,NH,H,HHW
Christ College ATM,25-03-2013,118,53,65,487600,256600,231000,MONDAY,NH,W,HWW
Christ College ATM,26-03-2013,96,42,54,391200,201500,189700,TUESDAY,NH,W,WWW
Christ College ATM,27-03-2013,118,63,55,562500,377100,185400,WEDNESDAY,NH,W,WWW
Christ College ATM,28-03-2013,170,78,92,778100,405500,372600,THURSDAY,NH,W,WWH
Christ College ATM,29-03-2013,82,40,42,352800,216400,136400,FRIDAY,C,H,WHH
Christ College ATM,30-03-2013,147,58,89,722900,312000,410900,SATURDAY,NH,H,HHH
Christ College ATM,31-03-2013,98,42,56,343800,160500,183300,SUNDAY,NH,H,HHW
Christ College ATM,01-04-2013,144,54,90,713100,370600,342500,MONDAY,NH,W,HWW
Christ College ATM,02-04-2013,147,62,85,518600,236500,282100,TUESDAY,NH,W,WWW
Christ College ATM,03-04-2013,133,71,62,621700,362800,258900,WEDNESDAY,NH,W,WWW
Christ College ATM,04-04-2013,135,57,78,456700,207800,248900,THURSDAY,NH,W,WWW
Christ College ATM,05-04-2013,171,81,90,823300,503100,320200,FRIDAY,NH,W,WWH
Christ College ATM,06-04-2013,169,69,100,874400,411700,462700,SATURDAY,NH,H,WHH
Christ College ATM,07-04-2013,109,39,70,419400,187800,231600,SUNDAY,NH,H,HHW
Christ College ATM,08-04-2013,118,35,83,539400,172400,367000,MONDAY,NH,W,HWW
Christ College ATM,09-04-2013,101,47,54,567300,332100,235200,TUESDAY,NH,W,WWW
Christ College ATM,10-04-2013,85,42,43,329500,190200,139300,WEDNESDAY,NH,W,WWH
Christ College ATM,11-04-2013,100,40,60,342100,160600,181500,THURSDAY,H,H,WHW
Christ College ATM,12-04-2013,125,54,71,484900,283900,201000,FRIDAY,NH,W,HWH
Christ College ATM,13-04-2013,140,79,61,618900,405700,213200,SATURDAY,NH,H,WHH
Christ College ATM,14-04-2013,98,40,58,385100,200600,184500,SUNDAY,N,H,HHW
Christ College ATM,15-04-2013,106,41,65,498600,246100,252500,MONDAY,NH,W,HWW
Christ College ATM,16-04-2013,127,63,64,478700,324900,153800,TUESDAY,NH,W,WWW
Christ College ATM,17-04-2013,133,67,66,582400,341800,240600,WEDNESDAY,NH,W,WWW
Christ College ATM,18-04-2013,106,44,62,406800,210200,196600,THURSDAY,NH,W,WWW
Christ College ATM,19-04-2013,162,69,93,569700,281100,288600,FRIDAY,NH,W,WWH
Christ College ATM,20-04-2013,138,64,74,525600,305100,220500,SATURDAY,NH,H,WHH
Christ College ATM,21-04-2013,91,42,49,234500,116200,118300,SUNDAY,NH,H,HHW
Christ College ATM,22-04-2013,105,45,60,334300,143800,190500,MONDAY,NH,W,HWW
Christ College ATM,23-04-2013,99,53,46,417000,307900,109100,TUESDAY,NH,W,WWH
Christ College ATM,24-04-2013,71,35,36,193800,109100,84700,WEDNESDAY,H,H,WHW
Christ College ATM,25-04-2013,125,57,68,584400,340000,244400,THURSDAY,NH,W,HWW
Christ College ATM,26-04-2013,120,47,73,480800,205800,275000,FRIDAY,NH,W,WWH
Christ College ATM,27-04-2013,118,53,65,550500,318500,232000,SATURDAY,NH,H,WHH
Christ College ATM,28-04-2013,70,32,38,196200,141000,55200,SUNDAY,NH,H,HHW
Christ College ATM,29-04-2013,116,51,65,490000,303400,186600,MONDAY,NH,W,HWW
Christ College ATM,30-04-2013,134,56,78,631600,318000,313600,TUESDAY,NH,W,WWH
Christ College ATM,01-05-2013,122,38,84,461300,167000,294300,WEDNESDAY,N,H,WHW
Christ College ATM,02-05-2013,143,67,76,825600,482100,343500,THURSDAY,NH,W,HWW
Christ College ATM,03-05-2013,142,65,77,780300,438000,342300,FRIDAY,NH,W,WWH
Christ College ATM,04-05-2013,156,71,85,721100,390300,330800,SATURDAY,NH,H,WHH
Christ College ATM,05-05-2013,145,62,83,527300,247800,279500,SUNDAY,NH,H,HHW
Christ College ATM,06-05-2013,148,57,91,528900,210300,318600,MONDAY,NH,W,HWW
Christ College ATM,07-05-2013,156,70,86,729100,361500,367600,TUESDAY,NH,W,WWW
Christ College ATM,08-05-2013,145,76,69,794000,509100,284900,WEDNESDAY,NH,W,WWW
Christ College ATM,09-05-2013,104,42,62,497700,241400,256300,THURSDAY,NH,W,WWW
Christ College ATM,10-05-2013,34,16,18,159200,103100,56100,FRIDAY,NH,W,WWH
Christ College ATM,11-05-2013,157,56,101,668200,230200,438000,SATURDAY,NH,H,WHH
Christ College ATM,12-05-2013,139,34,105,544100,136700,407400,SUNDAY,NH,H,HHW
Christ College ATM,13-05-2013,190,72,118,890100,387100,503000,MONDAY,NH,W,HWW
Christ College ATM,14-05-2013,111,53,58,470500,333600,136900,TUESDAY,NH,W,WWW
Christ College ATM,15-05-2013,103,50,53,616700,402500,214200,WEDNESDAY,NH,W,WWW
Christ College ATM,16-05-2013,94,46,48,507500,295800,211700,THURSDAY,NH,W,WWW
Christ College ATM,17-05-2013,101,54,47,419400,323700,95700,FRIDAY,NH,W,WWH
Christ College ATM,18-05-2013,95,55,40,415700,240200,175500,SATURDAY,NH,H,WHH
Christ College ATM,19-05-2013,82,41,41,248700,165100,83600,SUNDAY,NH,H,HHW
Christ College ATM,20-05-2013,104,45,59,425100,169400,255700,MONDAY,NH,W,HWW
Christ College ATM,21-05-2013,105,56,49,597000,379300,217700,TUESDAY,NH,W,WWW
Christ College ATM,22-05-2013,108,52,56,489200,249100,240100,WEDNESDAY,NH,W,WWW
Christ College ATM,23-05-2013,126,45,81,524300,217200,307100,THURSDAY,NH,W,WWW
Christ College ATM,24-05-2013,87,43,44,309200,159200,150000,FRIDAY,NH,W,WWH
Christ College ATM,25-05-2013,124,54,70,605900,303600,302300,SATURDAY,H,H,WHH
Christ College ATM,26-05-2013,88,41,47,293400,182400,111000,SUNDAY,NH,H,HHW
Christ College ATM,27-05-2013,170,51,119,875800,288700,587100,MONDAY,NH,W,HWW
Christ College ATM,28-05-2013,125,65,60,590300,296300,294000,TUESDAY,NH,W,WWW
Christ College ATM,29-05-2013,128,51,77,645100,317600,327500,WEDNESDAY,NH,W,WWW
Christ College ATM,30-05-2013,121,52,69,445700,240700,205000,THURSDAY,NH,W,WWW
Christ College ATM,31-05-2013,149,51,98,756300,254600,501700,FRIDAY,NH,W,WWH
Christ College ATM,01-06-2013,146,50,96,757500,261900,495600,SATURDAY,NH,H,WHH
Christ College ATM,02-06-2013,174,40,134,894700,182700,712000,SUNDAY,NH,H,HHW
Christ College ATM,03-06-2013,133,54,79,784500,461600,322900,MONDAY,NH,W,HWW
Christ College ATM,04-06-2013,177,56,121,958100,370400,587700,TUESDAY,NH,W,WWW
Christ College ATM,05-06-2013,205,61,144,955400,280900,674500,WEDNESDAY,NH,W,WWW
Christ College ATM,06-06-2013,121,67,54,597400,358400,239000,THURSDAY,NH,W,WWW
Christ College ATM,07-06-2013,123,55,68,526900,257600,269300,FRIDAY,NH,W,WWH
Christ College ATM,08-06-2013,127,68,59,652100,404500,247600,SATURDAY,NH,H,WHH
Christ College ATM,09-06-2013,94,43,51,363600,192600,171000,SUNDAY,NH,H,HHW
Christ College ATM,10-06-2013,115,40,75,521800,170100,351700,MONDAY,NH,W,HWW
Christ College ATM,11-06-2013,136,43,93,584900,225700,359200,TUESDAY,NH,W,WWW
Christ College ATM,12-06-2013,111,49,62,528100,247400,280700,WEDNESDAY,NH,W,WWW
Christ College ATM,13-06-2013,76,34,42,335000,190900,144100,THURSDAY,NH,W,WWW
Christ College ATM,14-06-2013,104,50,54,477100,255700,221400,FRIDAY,NH,W,WWH
Christ College ATM,15-06-2013,111,50,61,562000,329100,232900,SATURDAY,NH,H,WHH
Christ College ATM,16-06-2013,72,36,36,307000,194700,112300,SUNDAY,NH,H,HHW
Christ College ATM,17-06-2013,120,54,66,532700,272900,259800,MONDAY,NH,W,HWW
Christ College ATM,18-06-2013,85,51,34,323700,249800,73900,TUESDAY,NH,W,WWW
Christ College ATM,19-06-2013,111,61,50,615700,356900,258800,WEDNESDAY,NH,W,WWW
Christ College ATM,20-06-2013,87,49,38,263800,150000,113800,THURSDAY,NH,W,WWW
Christ College ATM,21-06-2013,89,39,50,447900,259200,188700,FRIDAY,NH,W,WWH
Christ College ATM,22-06-2013,154,65,89,780500,495600,284900,SATURDAY,NH,H,WHH
Christ College ATM,23-06-2013,106,29,77,298200,116800,181400,SUNDAY,NH,H,HHW
Christ College ATM,24-06-2013,93,55,38,332200,231000,101200,MONDAY,NH,W,HWW
Christ College ATM,25-06-2013,107,55,52,550200,290100,260100,TUESDAY,NH,W,WWW
Christ College ATM,26-06-2013,95,53,42,506000,365100,140900,WEDNESDAY,NH,W,WWW
Christ College ATM,27-06-2013,116,52,64,451400,247900,203500,THURSDAY,NH,W,WWW
Christ College ATM,28-06-2013,113,50,63,446100,254400,191700,FRIDAY,NH,W,WWH
Christ College ATM,29-06-2013,157,86,71,802000,496600,305400,SATURDAY,NH,H,WHH
Christ College ATM,30-06-2013,123,25,98,477200,117700,359500,SUNDAY,NH,H,HHW
Christ College ATM,01-07-2013,117,80,37,679100,457800,221300,MONDAY,NH,W,HWW
Christ College ATM,02-07-2013,193,82,111,875100,379900,495200,TUESDAY,NH,W,WWW
Christ College ATM,03-07-2013,182,80,102,867000,454900,412100,WEDNESDAY,NH,W,WWW
Christ College ATM,04-07-2013,217,76,141,1042900,403300,639600,THURSDAY,NH,W,WWW
Christ College ATM,05-07-2013,230,93,137,1202700,498500,704200,FRIDAY,NH,W,WWH
Christ College ATM,06-07-2013,133,69,64,696200,430600,265600,SATURDAY,NH,H,WHH
Christ College ATM,07-07-2013,93,34,59,328900,142800,186100,SUNDAY,NH,H,HHW
Christ College ATM,08-07-2013,165,67,98,812500,463600,348900,MONDAY,NH,W,HWW
Christ College ATM,09-07-2013,158,68,90,617900,331300,286600,TUESDAY,NH,W,WWW
Christ College ATM,10-07-2013,124,65,59,689900,450000,239900,WEDNESDAY,NH,W,WWW
Christ College ATM,11-07-2013,147,61,86,666400,370300,296100,THURSDAY,NH,W,WWW
Christ College ATM,12-07-2013,128,51,77,547800,277500,270300,FRIDAY,NH,W,WWH
Christ College ATM,13-07-2013,89,50,39,415200,283400,131800,SATURDAY,NH,H,WHH
Christ College ATM,14-07-2013,28,23,5,138800,123700,15100,SUNDAY,NH,H,HHW
Christ College ATM,15-07-2013,105,74,31,588600,438200,150400,MONDAY,NH,W,HWW
Christ College ATM,16-07-2013,106,54,52,450100,264200,185900,TUESDAY,NH,W,WWW
Christ College ATM,17-07-2013,160,64,96,792800,480700,312100,WEDNESDAY,NH,W,WWW
Christ College ATM,18-07-2013,177,72,105,886900,537900,349000,THURSDAY,NH,W,WWW
Christ College ATM,19-07-2013,140,46,94,527900,228600,299300,FRIDAY,NH,W,WWH
Christ College ATM,20-07-2013,134,47,87,583100,245400,337700,SATURDAY,NH,H,WHH
Christ College ATM,21-07-2013,75,35,40,203700,110100,93600,SUNDAY,NH,H,HHW
Christ College ATM,22-07-2013,104,53,51,356900,213100,143800,MONDAY,NH,W,HWW
Christ College ATM,23-07-2013,106,64,42,546400,376600,169800,TUESDAY,NH,W,WWW
Christ College ATM,24-07-2013,41,30,11,254200,190700,63500,WEDNESDAY,NH,W,WWW
Christ College ATM,25-07-2013,100,51,49,511700,281600,230100,THURSDAY,NH,W,WWW
Christ College ATM,26-07-2013,107,68,39,486800,366600,120200,FRIDAY,NH,W,WWH
Christ College ATM,27-07-2013,145,69,76,628800,437200,191600,SATURDAY,NH,H,WHH
Christ College ATM,28-07-2013,92,40,52,291900,194400,97500,SUNDAY,NH,H,HHW
Christ College ATM,29-07-2013,161,51,110,606600,222400,384200,MONDAY,NH,W,HWW
Christ College ATM,30-07-2013,120,55,65,401200,193800,207400,TUESDAY,NH,W,WWW
Christ College ATM,31-07-2013,208,68,140,821800,367700,454100,WEDNESDAY,NH,W,WWW
Christ College ATM,01-08-2013,161,69,92,750600,324300,426300,THURSDAY,NH,W,WWW
Christ College ATM,02-08-2013,194,65,129,956800,371100,585700,FRIDAY,NH,W,WWH
Christ College ATM,03-08-2013,164,42,122,740200,167200,573000,SATURDAY,NH,H,WHH
Christ College ATM,04-08-2013,90,32,58,283000,79400,203600,SUNDAY,NH,H,HHW
Christ College ATM,05-08-2013,181,79,102,950000,518400,431600,MONDAY,NH,W,HWW
Christ College ATM,06-08-2013,174,64,110,747000,249400,497600,TUESDAY,NH,W,WWW
Christ College ATM,07-08-2013,37,14,23,180400,90000,90400,WEDNESDAY,NH,W,WWW
Christ College ATM,08-08-2013,180,65,115,922300,374400,547900,THURSDAY,NH,W,WWW
Christ College ATM,09-08-2013,105,19,86,363800,60900,302900,FRIDAY,NH,W,WWH
Christ College ATM,10-08-2013,97,49,48,449700,225600,224100,SATURDAY,NH,H,WHH
Christ College ATM,11-08-2013,139,37,102,473400,127200,346200,SUNDAY,NH,H,HHW
Christ College ATM,12-08-2013,158,60,98,808200,419100,389100,MONDAY,NH,W,HWW
Christ College ATM,13-08-2013,169,95,74,897400,583600,313800,TUESDAY,NH,W,WWW
Christ College ATM,14-08-2013,116,52,64,554300,296900,257400,WEDNESDAY,NH,W,WWH
Christ College ATM,15-08-2013,65,20,45,198600,123200,75400,THURSDAY,N,H,WHW
Christ College ATM,16-08-2013,134,47,87,627900,290700,337200,FRIDAY,NH,W,HWH
Christ College ATM,17-08-2013,131,55,76,671000,400700,270300,SATURDAY,NH,H,WHH
Christ College ATM,18-08-2013,86,32,54,196500,101000,95500,SUNDAY,NH,H,HHW
Christ College ATM,19-08-2013,114,50,64,546400,282200,264200,MONDAY,NH,W,HWW
Christ College ATM,20-08-2013,140,62,78,507500,281800,225700,TUESDAY,NH,W,WWW
Christ College ATM,21-08-2013,103,63,40,564100,461800,102300,WEDNESDAY,NH,W,WWW
Christ College ATM,22-08-2013,132,53,79,572600,333500,239100,THURSDAY,NH,W,WWW
Christ College ATM,23-08-2013,123,73,50,683900,460900,223000,FRIDAY,NH,W,WWH
Christ College ATM,24-08-2013,51,28,23,286200,167900,118300,SATURDAY,NH,H,WHH
Christ College ATM,26-08-2013,76,32,44,233300,132900,100400,MONDAY,NH,W,HWW
Christ College ATM,27-08-2013,139,47,92,734500,245800,488700,TUESDAY,NH,W,WWW
Christ College ATM,28-08-2013,103,42,61,376000,191700,184300,WEDNESDAY,NH,W,WWW
Christ College ATM,29-08-2013,150,68,82,608400,370300,238100,THURSDAY,NH,W,WWW
Christ College ATM,30-08-2013,162,53,109,673800,239800,434000,FRIDAY,NH,W,WWH
Christ College ATM,31-08-2013,154,58,96,736400,285400,451000,SATURDAY,NH,H,WHH
Christ College ATM,01-09-2013,140,56,84,619100,220200,398900,SUNDAY,NH,H,HHW
Christ College ATM,02-09-2013,162,56,106,817800,305900,511900,MONDAY,NH,W,HWW
Christ College ATM,03-09-2013,157,59,98,838200,406700,431500,TUESDAY,NH,W,WWW
Christ College ATM,04-09-2013,220,60,160,964500,342100,622400,WEDNESDAY,NH,W,WWW
Christ College ATM,05-09-2013,156,58,98,828100,417900,410200,THURSDAY,NH,W,WWW
Christ College ATM,06-09-2013,149,64,85,494200,157700,336500,FRIDAY,NH,W,WWH
Christ College ATM,07-09-2013,130,78,52,782400,522000,260400,SATURDAY,NH,H,WHH
Christ College ATM,08-09-2013,73,32,41,345700,179100,166600,SUNDAY,NH,H,HHH
Christ College ATM,09-09-2013,96,33,63,532900,200400,332500,MONDAY,H,H,HHW
Christ College ATM,10-09-2013,197,66,131,932000,410000,522000,TUESDAY,NH,W,HWW
Christ College ATM,11-09-2013,120,43,77,617000,280800,336200,WEDNESDAY,NH,W,WWW
Christ College ATM,12-09-2013,116,45,71,562800,268400,294400,THURSDAY,NH,W,WWW
Christ College ATM,13-09-2013,137,60,77,753900,476800,277100,FRIDAY,NH,W,WWH
Christ College ATM,14-09-2013,137,57,80,650400,357800,292600,SATURDAY,NH,H,WHH
Christ College ATM,15-09-2013,129,26,103,519900,106600,413300,SUNDAY,NH,H,HHW
Christ College ATM,16-09-2013,123,35,88,411400,144500,266900,MONDAY,NH,W,HWW
Christ College ATM,17-09-2013,216,62,154,825300,272000,553300,TUESDAY,NH,W,WWW
Christ College ATM,18-09-2013,118,52,66,498800,278500,220300,WEDNESDAY,NH,W,WWW
Christ College ATM,19-09-2013,129,65,64,530800,324100,206700,THURSDAY,NH,W,WWW
Christ College ATM,20-09-2013,127,58,69,584100,336800,247300,FRIDAY,NH,W,WWH
Christ College ATM,21-09-2013,119,52,67,523800,263200,260600,SATURDAY,NH,H,WHH
Christ College ATM,22-09-2013,74,31,43,262400,67200,195200,SUNDAY,NH,H,HHW
Christ College ATM,23-09-2013,136,56,80,499300,204100,295200,MONDAY,NH,W,HWW
Christ College ATM,24-09-2013,130,60,70,575300,260900,314400,TUESDAY,NH,W,WWW
Christ College ATM,25-09-2013,119,75,44,472000,295000,177000,WEDNESDAY,NH,W,WWW
Christ College ATM,26-09-2013,137,85,52,774200,571100,203100,THURSDAY,NH,W,WWW
Christ College ATM,27-09-2013,108,46,62,346200,133200,213000,FRIDAY,NH,W,WWH
Christ College ATM,28-09-2013,109,69,40,773300,611400,161900,SATURDAY,NH,H,WHH
Christ College ATM,29-09-2013,127,52,75,517200,311700,205500,SUNDAY,NH,H,HHW
Christ College ATM,30-09-2013,116,68,48,515100,289000,226100,MONDAY,NH,W,HWW
Christ College ATM,01-10-2013,116,55,61,674500,351200,323300,TUESDAY,NH,W,WWH
Christ College ATM,02-10-2013,172,46,126,868500,341700,526800,WEDNESDAY,N,H,WHW
Christ College ATM,03-10-2013,161,74,87,713600,332400,381200,THURSDAY,NH,W,HWW
Christ College ATM,04-10-2013,192,66,126,823700,254400,569300,FRIDAY,NH,W,WWH
Christ College ATM,05-10-2013,224,73,151,996000,338800,657200,SATURDAY,NH,H,WHH
Christ College ATM,06-10-2013,135,57,78,526300,218200,308100,SUNDAY,NH,H,HHW
Christ College ATM,07-10-2013,195,53,142,864900,260400,604500,MONDAY,NH,W,HWW
Christ College ATM,08-10-2013,132,66,66,538200,274500,263700,TUESDAY,NH,W,WWW
Christ College ATM,09-10-2013,216,64,152,1035000,409800,625200,WEDNESDAY,NH,W,WWW
Christ College ATM,10-10-2013,185,64,121,881300,336100,545200,THURSDAY,NH,W,WWW
Christ College ATM,11-10-2013,132,61,71,509300,306900,202400,FRIDAY,NH,W,WWH
Christ College ATM,12-10-2013,120,54,66,489200,253200,236000,SATURDAY,NH,H,WHH
Christ College ATM,13-10-2013,127,31,96,595600,259400,336200,SUNDAY,NH,H,HHH
Christ College ATM,14-10-2013,126,34,92,488900,154700,334200,MONDAY,H,H,HHW
Christ College ATM,15-10-2013,126,66,60,530300,290700,239600,TUESDAY,NH,W,HWW
Christ College ATM,16-10-2013,95,31,64,369900,141600,228300,WEDNESDAY,NH,W,WWW
Christ College ATM,17-10-2013,109,65,44,567600,466200,101400,THURSDAY,NH,W,WWW
Christ College ATM,18-10-2013,79,51,28,397200,306800,90400,FRIDAY,NH,W,WWH
Christ College ATM,19-10-2013,120,52,68,568500,296000,272500,SATURDAY,NH,H,WHH
Christ College ATM,20-10-2013,109,36,73,424800,162800,262000,SUNDAY,NH,H,HHW
Christ College ATM,21-10-2013,117,47,70,562700,294300,268400,MONDAY,NH,W,HWW
Christ College ATM,22-10-2013,155,50,105,611900,258100,353800,TUESDAY,NH,W,WWW
Christ College ATM,23-10-2013,104,47,57,356000,218800,137200,WEDNESDAY,NH,W,WWW
Christ College ATM,24-10-2013,97,46,51,455600,258900,196700,THURSDAY,NH,W,WWW
Christ College ATM,25-10-2013,119,44,75,520800,198900,321900,FRIDAY,NH,W,WWH
Christ College ATM,26-10-2013,152,53,99,560700,150500,410200,SATURDAY,NH,H,WHH
Christ College ATM,27-10-2013,133,34,99,389700,135500,254200,SUNDAY,NH,H,HHW
Christ College ATM,28-10-2013,111,62,49,471000,344300,126700,MONDAY,NH,W,HWW
Christ College ATM,29-10-2013,155,68,87,772300,377000,395300,TUESDAY,NH,W,WWW
Christ College ATM,30-10-2013,235,80,155,1096400,415400,681000,WEDNESDAY,NH,W,WWW
Christ College ATM,31-10-2013,192,92,100,912000,471600,440400,THURSDAY,NH,W,WWW
Christ College ATM,01-11-2013,167,72,95,820600,369500,451100,FRIDAY,NH,W,WWH
Christ College ATM,02-11-2013,70,18,52,349900,73600,276300,SATURDAY,NH,H,WHH
Christ College ATM,03-11-2013,53,18,35,191400,86900,104500,SUNDAY,H,H,HHW
Christ College ATM,04-11-2013,169,66,103,914500,342500,572000,MONDAY,NH,W,HWH
Christ College ATM,05-11-2013,184,76,108,834500,376800,457700,TUESDAY,M,H,WHW
Christ College ATM,06-11-2013,146,54,92,724400,295300,429100,WEDNESDAY,NH,W,HWW
Christ College ATM,07-11-2013,152,53,99,686800,267300,419500,THURSDAY,NH,W,WWW
Christ College ATM,08-11-2013,127,53,74,664500,292300,372200,FRIDAY,NH,W,WWH
Christ College ATM,09-11-2013,191,57,134,956500,426100,530400,SATURDAY,NH,H,WHH
Christ College ATM,10-11-2013,164,44,120,709000,273700,435300,SUNDAY,NH,H,HHW
Christ College ATM,11-11-2013,245,58,187,899900,231300,668600,MONDAY,NH,W,HWW
Christ College ATM,12-11-2013,145,55,90,666700,334500,332200,TUESDAY,NH,W,WWW
Christ College ATM,13-11-2013,142,49,93,548600,260100,288500,WEDNESDAY,NH,W,WWW
Christ College ATM,14-11-2013,160,46,114,610100,210100,400000,THURSDAY,NH,W,WWW
Christ College ATM,15-11-2013,163,46,117,756800,294100,462700,FRIDAY,NH,W,WWH
Christ College ATM,16-11-2013,118,41,77,572800,265700,307100,SATURDAY,NH,H,WHH
Christ College ATM,17-11-2013,212,37,175,694200,139200,555000,SUNDAY,NH,H,HHW
Christ College ATM,18-11-2013,142,50,92,406300,142700,263600,MONDAY,NH,W,HWW
Christ College ATM,19-11-2013,119,52,67,464600,171900,292700,TUESDAY,NH,W,WWW
Christ College ATM,20-11-2013,163,53,110,652800,251000,401800,WEDNESDAY,NH,W,WWW
Christ College ATM,21-11-2013,183,45,138,562400,139500,422900,THURSDAY,NH,W,WWW
Christ College ATM,22-11-2013,139,46,93,473300,154600,318700,FRIDAY,NH,W,WWH
Christ College ATM,23-11-2013,176,65,111,728600,380200,348400,SATURDAY,NH,H,WHH
Christ College ATM,24-11-2013,124,31,93,416000,94300,321700,SUNDAY,NH,H,HHW
Christ College ATM,25-11-2013,212,60,152,793400,253400,540000,MONDAY,NH,W,HWW
Christ College ATM,26-11-2013,161,44,117,547200,162400,384800,TUESDAY,NH,W,WWW
Christ College ATM,27-11-2013,169,64,105,651300,363000,288300,WEDNESDAY,NH,W,WWW
Christ College ATM,28-11-2013,164,64,100,769600,448500,321100,THURSDAY,NH,W,WWW
Christ College ATM,29-11-2013,173,51,122,638900,247400,391500,FRIDAY,NH,W,WWH
Christ College ATM,30-11-2013,171,77,94,787400,387800,399600,SATURDAY,NH,H,WHH
Christ College ATM,01-12-2013,211,51,160,800100,170000,630100,SUNDAY,NH,H,HHW
Christ College ATM,02-12-2013,200,65,135,898300,292300,606000,MONDAY,NH,W,HWW
Christ College ATM,03-12-2013,222,76,146,1044200,403000,641200,TUESDAY,NH,W,WWW
Christ College ATM,04-12-2013,208,86,122,1050900,522200,528700,WEDNESDAY,NH,W,WWW
Christ College ATM,05-12-2013,186,66,120,855200,324400,530800,THURSDAY,NH,W,WWW
Christ College ATM,06-12-2013,151,40,111,508000,114600,393400,FRIDAY,NH,W,WWH
Christ College ATM,07-12-2013,148,70,78,683600,430000,253600,SATURDAY,NH,H,WHH
Christ College ATM,08-12-2013,94,36,58,320700,156600,164100,SUNDAY,NH,H,HHW
Christ College ATM,09-12-2013,125,63,62,734900,452600,282300,MONDAY,NH,W,HWW
Christ College ATM,10-12-2013,130,48,82,452600,215900,236700,TUESDAY,NH,W,WWW
Christ College ATM,11-12-2013,157,61,96,726500,330100,396400,WEDNESDAY,NH,W,WWW
Christ College ATM,12-12-2013,137,57,80,510500,338900,171600,THURSDAY,NH,W,WWW
Christ College ATM,23-12-2013,22,14,8,104000,81800,22200,MONDAY,NH,W,HWW
Christ College ATM,24-12-2013,110,94,16,522200,458900,63300,TUESDAY,NH,W,WWH
Christ College ATM,25-12-2013,76,38,38,233100,184400,48700,WEDNESDAY,C,H,WHW
Christ College ATM,26-12-2013,92,52,40,520800,363300,157500,THURSDAY,NH,W,HWW
Christ College ATM,27-12-2013,46,22,24,82400,48200,34200,FRIDAY,NH,W,WWH
Christ College ATM,28-12-2013,116,54,62,525600,330200,195400,SATURDAY,NH,H,WHH
Christ College ATM,29-12-2013,65,41,24,233300,175600,57700,SUNDAY,NH,H,HHW
Christ College ATM,30-12-2013,111,65,46,576800,391900,184900,MONDAY,NH,W,HWW
Christ College ATM,31-12-2013,110,59,51,376400,270400,106000,TUESDAY,NH,W,WWH
Christ College ATM,01-01-2014,85,35,50,318400,164100,154300,WEDNESDAY,C,H,WHW
Christ College ATM,02-01-2014,183,77,106,836100,347800,488300,THURSDAY,NH,W,HWW
Christ College ATM,03-01-2014,158,55,103,831500,330500,501000,FRIDAY,NH,W,WWH
Christ College ATM,04-01-2014,168,91,77,960600,527800,432800,SATURDAY,NH,H,WHH
Christ College ATM,05-01-2014,155,62,93,523900,223800,300100,SUNDAY,NH,H,HHW
Christ College ATM,06-01-2014,218,89,129,1087000,530200,556800,MONDAY,NH,W,HWW
Christ College ATM,07-01-2014,159,53,106,760600,258300,502300,TUESDAY,NH,W,WWW
Christ College ATM,08-01-2014,214,52,162,1028300,300500,727800,WEDNESDAY,NH,W,WWW
Christ College ATM,09-01-2014,138,52,86,577000,253300,323700,THURSDAY,NH,W,WWW
Christ College ATM,10-01-2014,174,71,103,785300,431400,353900,FRIDAY,NH,W,WWH
Christ College ATM,11-01-2014,136,76,60,710000,487000,223000,SATURDAY,NH,H,WHH
Christ College ATM,12-01-2014,99,40,59,353600,186800,166800,SUNDAY,NH,H,HHW
Christ College ATM,13-01-2014,155,47,108,664000,227300,436700,MONDAY,NH,W,HWH
Christ College ATM,14-01-2014,91,36,55,294400,96400,198000,TUESDAY,H,H,WHH
Christ College ATM,15-01-2014,78,39,39,313800,217600,96200,WEDNESDAY,H,H,HHH
Christ College ATM,16-01-2014,116,36,80,354500,119900,234600,THURSDAY,H,H,HHW
Christ College ATM,17-01-2014,239,58,181,1042800,248900,793900,FRIDAY,NH,W,HWH
Christ College ATM,18-01-2014,170,54,116,741600,337800,403800,SATURDAY,NH,H,WHH
Christ College ATM,19-01-2014,148,36,112,461600,96300,365300,SUNDAY,NH,H,HHW
Christ College ATM,20-01-2014,187,70,117,762100,327300,434800,MONDAY,NH,W,HWW
Christ College ATM,21-01-2014,175,59,116,801900,340400,461500,TUESDAY,NH,W,WWW
Christ College ATM,22-01-2014,157,67,90,705700,444300,261400,WEDNESDAY,NH,W,WWW
Christ College ATM,23-01-2014,110,69,41,461800,308500,153300,THURSDAY,NH,W,WWW
Christ College ATM,24-01-2014,86,45,41,362700,285300,77400,FRIDAY,NH,W,WWH
Christ College ATM,25-01-2014,144,61,83,636700,339900,296800,SATURDAY,NH,H,WHH
Christ College ATM,26-01-2014,137,35,102,349900,137100,212800,SUNDAY,N,H,HHW
Christ College ATM,27-01-2014,127,46,81,467400,216200,251200,MONDAY,NH,W,HWW
Christ College ATM,28-01-2014,139,33,106,444200,152500,291700,TUESDAY,NH,W,WWW
Christ College ATM,29-01-2014,148,46,102,549600,257200,292400,WEDNESDAY,NH,W,WWW
Christ College ATM,30-01-2014,126,43,83,592100,267700,324400,THURSDAY,NH,W,WWW
Christ College ATM,31-01-2014,231,67,164,980200,298000,682200,FRIDAY,NH,W,WWH
Christ College ATM,01-02-2014,195,57,138,937600,323600,614000,SATURDAY,NH,H,WHH
Christ College ATM,02-02-2014,267,50,217,1201400,274000,927400,SUNDAY,NH,H,HHW
Christ College ATM,03-02-2014,140,42,98,498600,173600,325000,MONDAY,NH,W,HWW
Christ College ATM,04-02-2014,192,71,121,981600,405400,576200,TUESDAY,NH,W,WWW
Christ College ATM,05-02-2014,173,74,99,708600,242600,466000,WEDNESDAY,NH,W,WWW
Christ College ATM,06-02-2014,220,68,152,866200,380400,485800,THURSDAY,NH,W,WWW
Christ College ATM,07-02-2014,183,46,137,643800,205900,437900,FRIDAY,NH,W,WWH
Christ College ATM,08-02-2014,236,80,156,1087300,473700,613600,SATURDAY,NH,H,WHH
Christ College ATM,09-02-2014,81,37,44,357400,181100,176300,SUNDAY,NH,H,HHW
Christ College ATM,10-02-2014,212,58,154,1127700,318000,809700,MONDAY,NH,W,HWW
Christ College ATM,11-02-2014,236,62,174,841100,230800,610300,TUESDAY,NH,W,WWW
Christ College ATM,12-02-2014,179,61,118,933600,397300,536300,WEDNESDAY,NH,W,WWW
Christ College ATM,13-02-2014,132,54,78,613800,293800,320000,THURSDAY,NH,W,WWW
Christ College ATM,14-02-2014,154,65,89,768100,365300,402800,FRIDAY,NH,W,WWH
Christ College ATM,15-02-2014,162,63,99,658000,281600,376400,SATURDAY,NH,H,WHH
Christ College ATM,16-02-2014,182,44,138,525000,119400,405600,SUNDAY,NH,H,HHW
Christ College ATM,17-02-2014,111,50,61,378700,205300,173400,MONDAY,NH,W,HWW
Christ College ATM,18-02-2014,102,57,45,484000,315200,168800,TUESDAY,NH,W,WWW
Christ College ATM,19-02-2014,160,67,93,666100,388600,277500,WEDNESDAY,NH,W,WWW
Christ College ATM,20-02-2014,150,54,96,680200,335000,345200,THURSDAY,NH,W,WWW
Christ College ATM,21-02-2014,196,66,130,731200,315200,416000,FRIDAY,NH,W,WWH
Christ College ATM,22-02-2014,126,68,58,582700,378200,204500,SATURDAY,NH,H,WHH
Christ College ATM,23-02-2014,146,46,100,482700,118200,364500,SUNDAY,NH,H,HHW
Christ College ATM,24-02-2014,192,44,148,639800,197900,441900,MONDAY,NH,W,HWW
Christ College ATM,25-02-2014,254,71,183,867100,342700,524400,TUESDAY,NH,W,WWW
Christ College ATM,26-02-2014,159,56,103,693700,329900,363800,WEDNESDAY,NH,W,WWW
Christ College ATM,27-02-2014,186,72,114,824500,417500,407000,THURSDAY,NH,W,WWW
Christ College ATM,28-02-2014,194,54,140,747200,220100,527100,FRIDAY,NH,W,WWH
Christ College ATM,01-03-2014,225,66,159,1119600,370100,749500,SATURDAY,NH,H,WHH
Christ College ATM,02-03-2014,251,70,181,1017100,301400,715700,SUNDAY,NH,H,HHW
Christ College ATM,03-03-2014,373,63,310,1670800,292000,1378800,MONDAY,NH,W,HWW
Christ College ATM,04-03-2014,301,84,217,1487000,553100,933900,TUESDAY,NH,W,WWW
Christ College ATM,05-03-2014,294,80,214,1447400,512100,935300,WEDNESDAY,NH,W,WWW
Christ College ATM,06-03-2014,189,60,129,945900,243200,702700,THURSDAY,NH,W,WWW
Christ College ATM,07-03-2014,211,41,170,908700,204600,704100,FRIDAY,NH,W,WWH
Christ College ATM,08-03-2014,272,69,203,1252500,362800,889700,SATURDAY,NH,H,WHH
Christ College ATM,09-03-2014,136,35,101,529800,199000,330800,SUNDAY,NH,H,HHW
Christ College ATM,10-03-2014,208,71,137,994200,385600,608600,MONDAY,NH,W,HWW
Christ College ATM,11-03-2014,200,54,146,762800,251100,511700,TUESDAY,NH,W,WWW
Christ College ATM,12-03-2014,127,48,79,685700,342300,343400,WEDNESDAY,NH,W,WWW
Christ College ATM,13-03-2014,118,55,63,530100,282000,248100,THURSDAY,NH,W,WWW
Christ College ATM,14-03-2014,100,53,47,442200,293700,148500,FRIDAY,NH,W,WWH
Christ College ATM,15-03-2014,132,69,63,582300,332100,250200,SATURDAY,NH,H,WHH
Christ College ATM,16-03-2014,143,40,103,586200,208400,377800,SUNDAY,NH,H,HHW
Christ College ATM,17-03-2014,204,68,136,819800,369300,450500,MONDAY,NH,W,HWW
Christ College ATM,18-03-2014,206,64,142,924000,426100,497900,TUESDAY,NH,W,WWW
Christ College ATM,19-03-2014,127,66,61,699700,468700,231000,WEDNESDAY,NH,W,WWW
Christ College ATM,20-03-2014,128,52,76,474400,240600,233800,THURSDAY,NH,W,WWW
Christ College ATM,21-03-2014,128,51,77,591900,227300,364600,FRIDAY,NH,W,WWH
Christ College ATM,22-03-2014,164,59,105,737000,382500,354500,SATURDAY,NH,H,WHH
Christ College ATM,23-03-2014,120,28,92,465700,190800,274900,SUNDAY,NH,H,HHW
Christ College ATM,24-03-2014,88,65,23,468100,393700,74400,MONDAY,NH,W,HWW
Christ College ATM,25-03-2014,128,75,53,732500,550500,182000,TUESDAY,NH,W,WWW
Christ College ATM,26-03-2014,152,59,93,701200,383700,317500,WEDNESDAY,NH,W,WWW
Christ College ATM,27-03-2014,142,57,85,506800,243900,262900,THURSDAY,NH,W,WWW
Christ College ATM,28-03-2014,203,71,132,773000,349900,423100,FRIDAY,NH,W,WWH
Christ College ATM,29-03-2014,221,82,139,1086100,516000,570100,SATURDAY,NH,H,WHH
Christ College ATM,30-03-2014,111,64,47,439800,331500,108300,SUNDAY,NH,H,HHH
Christ College ATM,31-03-2014,105,41,64,581100,222300,358800,MONDAY,H,H,HHW
Christ College ATM,02-04-2014,138,68,70,820300,495800,324500,WEDNESDAY,NH,W,WWW
Christ College ATM,03-04-2014,235,81,154,1153500,482100,671400,THURSDAY,NH,W,WWW
Christ College ATM,04-04-2014,131,49,82,605800,224000,381800,FRIDAY,NH,W,WWH
Christ College ATM,05-04-2014,140,71,69,831700,456100,375600,SATURDAY,NH,H,WHH
Christ College ATM,06-04-2014,186,59,127,735300,243700,491600,SUNDAY,NH,H,HHW
Christ College ATM,07-04-2014,227,73,154,1154300,440200,714100,MONDAY,NH,W,HWW
Christ College ATM,08-04-2014,248,75,173,1163100,468600,694500,TUESDAY,NH,W,WWW
Christ College ATM,09-04-2014,160,59,101,803400,366600,436800,WEDNESDAY,NH,W,WWW
Christ College ATM,10-04-2014,166,63,103,910400,505300,405100,THURSDAY,NH,W,WWW
Christ College ATM,11-04-2014,157,46,111,916200,323000,593200,FRIDAY,NH,W,WWH
Christ College ATM,12-04-2014,215,75,140,915700,401300,514400,SATURDAY,NH,H,WHH
Christ College ATM,13-04-2014,117,12,105,458200,49300,408900,SUNDAY,H,H,HHH
Christ College ATM,14-04-2014,71,0,71,314100,0,314100,MONDAY,H,H,HHW
Christ College ATM,15-04-2014,137,34,103,449100,151300,297800,TUESDAY,NH,W,HWW
Christ College ATM,16-04-2014,180,81,99,1102200,589700,512500,WEDNESDAY,NH,W,WWW
Christ College ATM,17-04-2014,157,71,86,770000,471800,298200,THURSDAY,NH,W,WWH
Christ College ATM,18-04-2014,91,33,58,457600,176100,281500,FRIDAY,C,H,WHH
Christ College ATM,19-04-2014,111,57,54,630200,456900,173300,SATURDAY,NH,H,HHH
Christ College ATM,20-04-2014,64,33,31,214700,150200,64500,SUNDAY,NH,H,HHW
Christ College ATM,21-04-2014,109,59,50,469100,308000,161100,MONDAY,NH,W,HWW
Christ College ATM,22-04-2014,125,43,82,510700,190800,319900,TUESDAY,NH,W,WWW
Christ College ATM,23-04-2014,108,58,50,618700,450800,167900,WEDNESDAY,NH,W,WWW
Christ College ATM,24-04-2014,54,35,19,143400,83300,60100,THURSDAY,NH,W,WWW
Christ College ATM,25-04-2014,116,50,66,502200,262100,240100,FRIDAY,NH,W,WWH
Christ College ATM,26-04-2014,118,59,59,619000,373900,245100,SATURDAY,NH,H,WHH
Christ College ATM,27-04-2014,68,29,39,248300,84200,164100,SUNDAY,NH,H,HHW
Christ College ATM,28-04-2014,117,71,46,703700,489100,214600,MONDAY,NH,W,HWW
Christ College ATM,29-04-2014,100,51,49,419900,208300,211600,TUESDAY,NH,W,WWW
Christ College ATM,30-04-2014,169,70,99,880100,406300,473800,WEDNESDAY,NH,W,WWH
Christ College ATM,01-05-2014,80,39,41,478600,211700,266900,THURSDAY,N,H,WHW
Christ College ATM,02-05-2014,138,66,72,718600,376200,342400,FRIDAY,NH,W,HWH
Christ College ATM,03-05-2014,155,75,80,797800,426900,370900,SATURDAY,NH,H,WHH
Christ College ATM,04-05-2014,112,41,71,533700,200200,333500,SUNDAY,NH,H,HHW
Christ College ATM,05-05-2014,129,43,86,676900,286800,390100,MONDAY,NH,W,HWW
Christ College ATM,06-05-2014,152,67,85,821400,329500,491900,TUESDAY,NH,W,WWW
Christ College ATM,07-05-2014,139,50,89,626000,210700,415300,WEDNESDAY,NH,W,WWW
Christ College ATM,08-05-2014,130,53,77,684200,367700,316500,THURSDAY,NH,W,WWW
Christ College ATM,09-05-2014,138,63,75,675100,283700,391400,FRIDAY,NH,W,WWH
Christ College ATM,10-05-2014,113,51,62,619400,333000,286400,SATURDAY,NH,H,WHH
Christ College ATM,11-05-2014,60,39,21,254600,206200,48400,SUNDAY,NH,H,HHW
Christ College ATM,12-05-2014,117,57,60,570800,324400,246400,MONDAY,NH,W,HWW
Christ College ATM,13-05-2014,138,47,91,684000,289700,394300,TUESDAY,NH,W,WWW
Christ College ATM,14-05-2014,147,36,111,689300,204200,485100,WEDNESDAY,NH,W,WWW
Christ College ATM,15-05-2014,175,72,103,901200,423400,477800,THURSDAY,NH,W,WWW
Christ College ATM,16-05-2014,152,46,106,591000,210800,380200,FRIDAY,NH,W,WWH
Christ College ATM,17-05-2014,161,52,109,782600,272800,509800,SATURDAY,NH,H,WHH
Christ College ATM,18-05-2014,141,33,108,477200,75300,401900,SUNDAY,NH,H,HHW
Christ College ATM,19-05-2014,206,67,139,861200,379500,481700,MONDAY,NH,W,HWW
Christ College ATM,20-05-2014,171,59,112,881000,386000,495000,TUESDAY,NH,W,WWW
Christ College ATM,21-05-2014,160,46,114,827000,263500,563500,WEDNESDAY,NH,W,WWW
Christ College ATM,22-05-2014,181,58,123,882000,286800,595200,THURSDAY,NH,W,WWW
Christ College ATM,23-05-2014,143,55,88,627800,263000,364800,FRIDAY,NH,W,WWH
Christ College ATM,24-05-2014,143,54,89,619000,267600,351400,SATURDAY,NH,H,WHH
Christ College ATM,25-05-2014,101,39,62,368900,152100,216800,SUNDAY,NH,H,HHW
Christ College ATM,26-05-2014,207,77,130,1085600,466400,619200,MONDAY,NH,W,HWW
Christ College ATM,27-05-2014,152,60,92,574300,261200,313100,TUESDAY,NH,W,WWW
Christ College ATM,28-05-2014,138,50,88,733600,273800,459800,WEDNESDAY,NH,W,WWW
Christ College ATM,29-05-2014,297,60,237,1269500,322900,946600,THURSDAY,NH,W,WWW
Christ College ATM,30-05-2014,124,47,77,676300,271500,404800,FRIDAY,NH,W,WWH
Christ College ATM,31-05-2014,219,53,166,1025200,246000,779200,SATURDAY,NH,H,WHH
Christ College ATM,01-06-2014,240,46,194,934400,226200,708200,SUNDAY,NH,H,HHW
Christ College ATM,02-06-2014,170,37,133,951900,245400,706500,MONDAY,NH,W,HWW
Christ College ATM,03-06-2014,191,56,135,1082200,352200,730000,TUESDAY,NH,W,WWW
Christ College ATM,04-06-2014,212,57,155,1238700,381600,857100,WEDNESDAY,NH,W,WWW
Christ College ATM,05-06-2014,225,68,157,1132200,432900,699300,THURSDAY,NH,W,WWW
Christ College ATM,06-06-2014,197,57,140,1091900,392900,699000,FRIDAY,NH,W,WWH
Christ College ATM,07-06-2014,201,75,126,1221000,564800,656200,SATURDAY,NH,H,WHH
Christ College ATM,08-06-2014,105,41,64,569700,280200,289500,SUNDAY,NH,H,HHW
Christ College ATM,09-06-2014,178,48,130,844400,225800,618600,MONDAY,NH,W,HWW
Christ College ATM,10-06-2014,124,51,73,617600,293500,324100,TUESDAY,NH,W,WWW
Christ College ATM,11-06-2014,169,62,107,839200,327000,512200,WEDNESDAY,NH,W,WWW
Christ College ATM,12-06-2014,111,56,55,466200,262200,204000,THURSDAY,NH,W,WWW
Christ College ATM,13-06-2014,74,30,44,396000,183600,212400,FRIDAY,NH,W,WWH
Christ College ATM,14-06-2014,128,58,70,453400,183800,269600,SATURDAY,NH,H,WHH
Christ College ATM,15-06-2014,129,39,90,400700,148200,252500,SUNDAY,NH,H,HHW
Christ College ATM,16-06-2014,228,58,170,972000,367500,604500,MONDAY,NH,W,HWW
Christ College ATM,17-06-2014,148,59,89,626200,247900,378300,TUESDAY,NH,W,WWW
Christ College ATM,18-06-2014,122,53,69,580800,309000,271800,WEDNESDAY,NH,W,WWW
Christ College ATM,19-06-2014,114,52,62,471700,246500,225200,THURSDAY,NH,W,WWW
Christ College ATM,20-06-2014,127,59,68,560600,369800,190800,FRIDAY,NH,W,WWH
Christ College ATM,21-06-2014,134,58,76,714800,376500,338300,SATURDAY,NH,H,WHH
Christ College ATM,22-06-2014,96,40,56,380100,188500,191600,SUNDAY,NH,H,HHW
Christ College ATM,23-06-2014,100,46,54,402300,226800,175500,MONDAY,NH,W,HWW
Christ College ATM,24-06-2014,111,43,68,413900,150800,263100,TUESDAY,NH,W,WWW
Christ College ATM,25-06-2014,78,39,39,346200,252200,94000,WEDNESDAY,NH,W,WWW
Christ College ATM,26-06-2014,106,45,61,621800,360500,261300,THURSDAY,NH,W,WWW
Christ College ATM,27-06-2014,100,43,57,339400,185700,153700,FRIDAY,NH,W,WWH
Christ College ATM,28-06-2014,121,55,66,536200,293300,242900,SATURDAY,NH,H,WHH
Christ College ATM,29-06-2014,84,29,55,347100,133400,213700,SUNDAY,NH,H,HHW
Christ College ATM,30-06-2014,133,60,73,627400,288500,338900,MONDAY,NH,W,HWW
Christ College ATM,01-07-2014,247,56,191,1208500,210800,997700,TUESDAY,NH,W,WWW
Christ College ATM,02-07-2014,139,43,96,650500,198600,451900,WEDNESDAY,NH,W,WWW
Christ College ATM,03-07-2014,271,63,208,1330000,339200,990800,THURSDAY,NH,W,WWW
Christ College ATM,04-07-2014,173,51,122,799900,293300,506600,FRIDAY,NH,W,WWH
Christ College ATM,05-07-2014,192,52,140,1076100,389600,686500,SATURDAY,NH,H,WHH
Christ College ATM,06-07-2014,156,34,122,735600,162300,573300,SUNDAY,NH,H,HHW
Christ College ATM,07-07-2014,260,80,180,1273700,399000,874700,MONDAY,NH,W,HWW
Christ College ATM,08-07-2014,187,84,103,872500,486500,386000,TUESDAY,NH,W,WWW
Christ College ATM,09-07-2014,160,47,113,726200,239000,487200,WEDNESDAY,NH,W,WWW
Christ College ATM,10-07-2014,123,49,74,471200,253400,217800,THURSDAY,NH,W,WWW
Christ College ATM,11-07-2014,165,60,105,721000,343700,377300,FRIDAY,NH,W,WWH
Christ College ATM,12-07-2014,183,53,130,956700,253700,703000,SATURDAY,NH,H,WHH
Christ College ATM,13-07-2014,78,31,47,200500,103900,96600,SUNDAY,NH,H,HHW
Christ College ATM,14-07-2014,193,66,127,854000,356200,497800,MONDAY,NH,W,HWW
Christ College ATM,15-07-2014,156,55,101,818300,318900,499400,TUESDAY,NH,W,WWW
Christ College ATM,16-07-2014,138,71,67,641400,378000,263400,WEDNESDAY,NH,W,WWW
Christ College ATM,17-07-2014,107,56,51,548900,321500,227400,THURSDAY,NH,W,WWW
Christ College ATM,18-07-2014,116,52,64,553300,333800,219500,FRIDAY,NH,W,WWH
Christ College ATM,19-07-2014,158,75,83,862600,535100,327500,SATURDAY,NH,H,WHH
Christ College ATM,20-07-2014,115,26,89,424000,115000,309000,SUNDAY,NH,H,HHW
Christ College ATM,21-07-2014,91,40,51,483000,273000,210000,MONDAY,NH,W,HWW
Christ College ATM,22-07-2014,95,50,45,436000,282200,153800,TUESDAY,NH,W,WWW
Christ College ATM,23-07-2014,105,51,54,472200,327400,144800,WEDNESDAY,NH,W,WWW
Christ College ATM,24-07-2014,119,47,72,470000,234400,235600,THURSDAY,NH,W,WWW
Christ College ATM,25-07-2014,119,57,62,504600,303600,201000,FRIDAY,NH,W,WWH
Christ College ATM,26-07-2014,120,50,70,369300,171300,198000,SATURDAY,NH,H,WHH
Christ College ATM,27-07-2014,60,27,33,167700,83200,84500,SUNDAY,NH,H,HHW
Christ College ATM,28-07-2014,119,64,55,496100,330200,165900,MONDAY,NH,W,HWH
Christ College ATM,29-07-2014,75,36,39,231100,175000,56100,TUESDAY,M,H,WHW
Christ College ATM,30-07-2014,100,36,64,386800,156100,230700,WEDNESDAY,NH,W,HWW
Christ College ATM,31-07-2014,157,60,97,735500,323000,412500,THURSDAY,NH,W,WWW
Christ College ATM,01-08-2014,174,52,122,865300,220900,644400,FRIDAY,NH,W,WWH
Christ College ATM,02-08-2014,223,83,140,1162600,494700,667900,SATURDAY,NH,H,WHH
Christ College ATM,03-08-2014,191,49,142,877900,300600,577300,SUNDAY,NH,H,HHW
Christ College ATM,04-08-2014,228,73,155,1230000,400900,829100,MONDAY,NH,W,HWW
Christ College ATM,05-08-2014,167,64,103,781900,339400,442500,TUESDAY,NH,W,WWW
Christ College ATM,06-08-2014,159,65,94,687400,332200,355200,WEDNESDAY,NH,W,WWW
Christ College ATM,07-08-2014,202,58,144,1025400,430300,595100,THURSDAY,NH,W,WWW
Christ College ATM,08-08-2014,167,59,108,661600,327900,333700,FRIDAY,NH,W,WWH
Christ College ATM,09-08-2014,160,76,84,822000,458400,363600,SATURDAY,NH,H,WHH
Christ College ATM,10-08-2014,173,53,120,638900,210900,428000,SUNDAY,NH,H,HHW
Christ College ATM,11-08-2014,182,54,128,596800,237600,359200,MONDAY,NH,W,HWW
Christ College ATM,12-08-2014,130,46,84,466700,123100,343600,TUESDAY,NH,W,WWW
Christ College ATM,13-08-2014,158,43,115,535300,208800,326500,WEDNESDAY,NH,W,WWW
Christ College ATM,14-08-2014,212,66,146,905200,428100,477100,THURSDAY,NH,W,WWH
Christ College ATM,15-08-2014,100,32,68,365300,134900,230400,FRIDAY,N,H,WHH
Christ College ATM,16-08-2014,186,80,106,991500,533000,458500,SATURDAY,NH,H,HHH
Christ College ATM,17-08-2014,136,44,92,463400,178200,285200,SUNDAY,H,H,HHW
Christ College ATM,18-08-2014,164,49,115,592600,243700,348900,MONDAY,NH,W,HWW
Christ College ATM,19-08-2014,142,57,85,441500,234700,206800,TUESDAY,NH,W,WWW
Christ College ATM,20-08-2014,125,46,79,593100,296900,296200,WEDNESDAY,NH,W,WWW
Christ College ATM,21-08-2014,140,52,88,707900,430200,277700,THURSDAY,NH,W,WWW
Christ College ATM,22-08-2014,155,54,101,609800,211800,398000,FRIDAY,NH,W,WWH
Christ College ATM,23-08-2014,221,65,156,785100,330700,454400,SATURDAY,NH,H,WHH
Christ College ATM,24-08-2014,125,34,91,361800,120300,241500,SUNDAY,NH,H,HHW
Christ College ATM,25-08-2014,137,46,91,570700,222100,348600,MONDAY,NH,W,HWW
Christ College ATM,26-08-2014,127,53,74,635500,347700,287800,TUESDAY,NH,W,WWW
Christ College ATM,27-08-2014,147,52,95,635500,336900,298600,WEDNESDAY,NH,W,WWW
Christ College ATM,28-08-2014,237,65,172,974000,346100,627900,THURSDAY,NH,W,WWH
Christ College ATM,29-08-2014,112,27,85,502800,195000,307800,FRIDAY,H,H,WHH
Christ College ATM,30-08-2014,269,64,205,1220000,280400,939600,SATURDAY,NH,H,HHH
Christ College ATM,31-08-2014,186,27,159,599400,71500,527900,SUNDAY,NH,H,HHW
Christ College ATM,01-09-2014,215,54,161,957100,219800,737300,MONDAY,NH,W,HWW
Christ College ATM,02-09-2014,173,64,109,845300,341400,503900,TUESDAY,NH,W,WWW
Christ College ATM,03-09-2014,191,62,129,904100,349000,555100,WEDNESDAY,NH,W,WWW
Christ College ATM,04-09-2014,250,81,169,1212100,427300,784800,THURSDAY,NH,W,WWW
Christ College ATM,05-09-2014,158,52,106,778400,291500,486900,FRIDAY,NH,W,WWH
Christ College ATM,06-09-2014,231,69,162,1107800,446600,661200,SATURDAY,NH,H,WHH
Christ College ATM,07-09-2014,259,42,217,921600,129300,792300,SUNDAY,NH,H,HHW
Christ College ATM,08-09-2014,251,57,194,1103600,316400,787200,MONDAY,NH,W,HWW
Christ College ATM,09-09-2014,164,50,114,668100,214900,453200,TUESDAY,NH,W,WWW
Christ College ATM,10-09-2014,130,65,65,622700,408200,214500,WEDNESDAY,NH,W,WWW
Christ College ATM,11-09-2014,120,46,74,483400,249700,233700,THURSDAY,NH,W,WWW
Christ College ATM,12-09-2014,167,47,120,684600,258700,425900,FRIDAY,NH,W,WWH
Christ College ATM,13-09-2014,186,66,120,888800,471700,417100,SATURDAY,NH,H,WHH
Christ College ATM,14-09-2014,155,50,105,569900,264200,305700,SUNDAY,NH,H,HHW
Christ College ATM,15-09-2014,197,56,141,844000,292600,551400,MONDAY,NH,W,HWW
Christ College ATM,16-09-2014,111,33,78,373800,136800,237000,TUESDAY,NH,W,WWW
Christ College ATM,17-09-2014,151,69,82,747300,447100,300200,WEDNESDAY,NH,W,WWW
Christ College ATM,18-09-2014,160,49,111,556200,220900,335300,THURSDAY,NH,W,WWW
Christ College ATM,19-09-2014,122,56,66,624100,390700,233400,FRIDAY,NH,W,WWH
Christ College ATM,20-09-2014,151,57,94,762000,387200,374800,SATURDAY,NH,H,WHH
Christ College ATM,21-09-2014,75,20,55,169600,52400,117200,SUNDAY,NH,H,HHW
Christ College ATM,22-09-2014,144,58,86,497000,250100,246900,MONDAY,NH,W,HWW
Christ College ATM,23-09-2014,97,39,58,384400,225200,159200,TUESDAY,NH,W,WWW
Christ College ATM,24-09-2014,103,51,52,394100,250400,143700,WEDNESDAY,NH,W,WWW
Christ College ATM,25-09-2014,113,43,70,405800,189500,216300,THURSDAY,NH,W,WWW
Christ College ATM,26-09-2014,99,40,59,348100,173200,174900,FRIDAY,NH,W,WWH
Christ College ATM,27-09-2014,124,39,85,514900,263100,251800,SATURDAY,NH,H,WHH
Christ College ATM,28-09-2014,223,52,171,823700,256000,567700,SUNDAY,NH,H,HHW
Christ College ATM,29-09-2014,265,53,212,1123200,282900,840300,MONDAY,NH,W,HWW
Christ College ATM,30-09-2014,265,54,211,1065000,270000,795000,TUESDAY,NH,W,WWW
Christ College ATM,01-10-2014,266,55,211,1314700,345500,969200,WEDNESDAY,NH,W,WWH
Christ College ATM,02-10-2014,209,46,163,906200,184100,722100,THURSDAY,N,H,WHH
Christ College ATM,03-10-2014,18,0,18,81300,0,81300,FRIDAY,H,H,HHH
Christ College ATM,04-10-2014,156,62,94,764900,343100,421800,SATURDAY,NH,H,HHH
Christ College ATM,05-10-2014,203,39,164,831600,190500,641100,SUNDAY,M,H,HHW
Christ College ATM,06-10-2014,221,49,172,947500,226500,721000,MONDAY,NH,W,HWW
Christ College ATM,07-10-2014,290,58,232,1391800,307600,1084200,TUESDAY,NH,W,WWW
Christ College ATM,08-10-2014,340,69,271,1699000,367600,1331400,WEDNESDAY,NH,W,WWW
Christ College ATM,09-10-2014,266,67,199,1194100,357100,837000,THURSDAY,NH,W,WWW
Christ College ATM,10-10-2014,274,64,210,1205800,240800,965000,FRIDAY,NH,W,WWH
Christ College ATM,11-10-2014,247,67,180,1339400,458500,880900,SATURDAY,NH,H,WHH
Christ College ATM,12-10-2014,125,44,81,405200,190000,215200,SUNDAY,NH,H,HHW
Christ College ATM,13-10-2014,199,52,147,874400,244300,630100,MONDAY,NH,W,HWW
Christ College ATM,14-10-2014,108,48,60,587400,376300,211100,TUESDAY,NH,W,WWW
Christ College ATM,15-10-2014,107,46,61,518800,318500,200300,WEDNESDAY,NH,W,WWW
Christ College ATM,16-10-2014,134,54,80,660300,360800,299500,THURSDAY,NH,W,WWW
Christ College ATM,17-10-2014,189,63,126,824600,402400,422200,FRIDAY,NH,W,WWH
Christ College ATM,18-10-2014,235,73,162,1203400,487300,716100,SATURDAY,NH,H,WHH
Christ College ATM,19-10-2014,166,37,129,680100,208500,471600,SUNDAY,NH,H,HHW
Christ College ATM,20-10-2014,261,80,181,1235000,534600,700400,MONDAY,NH,W,HWW
Christ College ATM,21-10-2014,262,60,202,1203800,350900,852900,TUESDAY,NH,W,WWH
Christ College ATM,22-10-2014,123,25,98,356700,73700,283000,WEDNESDAY,H,H,WHW
Christ College ATM,23-10-2014,115,38,77,540600,237900,302700,THURSDAY,NH,W,HWW
Christ College ATM,24-10-2014,181,42,139,648900,272200,376700,FRIDAY,NH,W,WWH
Christ College ATM,25-10-2014,178,55,123,767500,360500,407000,SATURDAY,NH,H,WHH
Christ College ATM,26-10-2014,153,48,105,531400,235500,295900,SUNDAY,NH,H,HHW
Christ College ATM,27-10-2014,126,50,76,537900,249500,288400,MONDAY,NH,W,HWW
Christ College ATM,28-10-2014,114,51,63,333500,144800,188700,TUESDAY,NH,W,WWW
Christ College ATM,29-10-2014,110,41,69,481600,220000,261600,WEDNESDAY,NH,W,WWW
Christ College ATM,30-10-2014,117,47,70,465100,212300,252800,THURSDAY,NH,W,WWW
Christ College ATM,31-10-2014,104,32,72,510900,202800,308100,FRIDAY,NH,W,WWH
Christ College ATM,01-11-2014,178,61,117,800000,216100,583900,SATURDAY,NH,H,WHH
Christ College ATM,02-11-2014,172,38,134,888700,142000,746700,SUNDAY,NH,H,HHW
Christ College ATM,03-11-2014,271,55,216,1178000,221800,956200,MONDAY,NH,W,HWH
Christ College ATM,04-11-2014,142,63,79,592700,257300,335400,TUESDAY,M,H,WHW
Christ College ATM,05-11-2014,194,74,120,929900,403900,526000,WEDNESDAY,NH,W,HWW
Christ College ATM,06-11-2014,164,72,92,804800,415000,389800,THURSDAY,NH,W,WWW
Christ College ATM,07-11-2014,158,62,96,786200,339900,446300,FRIDAY,NH,W,WWH
Christ College ATM,08-11-2014,262,77,185,1292800,514700,778100,SATURDAY,NH,H,WHH
Christ College ATM,09-11-2014,82,13,69,311500,47500,264000,SUNDAY,NH,H,HHW
Christ College ATM,10-11-2014,184,54,130,780000,296100,483900,MONDAY,NH,W,HWW
Christ College ATM,11-11-2014,193,72,121,987100,522200,464900,TUESDAY,NH,W,WWW
Christ College ATM,12-11-2014,183,47,136,856000,284600,571400,WEDNESDAY,NH,W,WWW
Christ College ATM,13-11-2014,122,48,74,623800,308700,315100,THURSDAY,NH,W,WWW
Christ College ATM,14-11-2014,108,43,65,486200,201500,284700,FRIDAY,NH,W,WWH
Christ College ATM,15-11-2014,132,47,85,710700,281300,429400,SATURDAY,NH,H,WHH
Christ College ATM,16-11-2014,120,34,86,416300,137300,279000,SUNDAY,NH,H,HHW
Christ College ATM,17-11-2014,177,55,122,690500,239400,451100,MONDAY,NH,W,HWW
Christ College ATM,18-11-2014,157,59,98,674600,335500,339100,TUESDAY,NH,W,WWW
Christ College ATM,19-11-2014,150,52,98,485400,205400,280000,WEDNESDAY,NH,W,WWW
Christ College ATM,20-11-2014,154,62,92,641300,338700,302600,THURSDAY,NH,W,WWW
Christ College ATM,21-11-2014,86,43,43,392600,255900,136700,FRIDAY,NH,W,WWH
Christ College ATM,22-11-2014,131,62,69,662600,394500,268100,SATURDAY,NH,H,WHH
Christ College ATM,23-11-2014,88,38,50,277900,159500,118400,SUNDAY,NH,H,HHW
Christ College ATM,24-11-2014,110,57,53,439700,251900,187800,MONDAY,NH,W,HWW
Christ College ATM,25-11-2014,131,55,76,495300,292000,203300,TUESDAY,NH,W,WWW
Christ College ATM,26-11-2014,115,33,82,479300,136800,342500,WEDNESDAY,NH,W,WWW
Christ College ATM,27-11-2014,97,44,53,481200,263600,217600,THURSDAY,NH,W,WWW
Christ College ATM,28-11-2014,101,35,66,517600,187100,330500,FRIDAY,NH,W,WWH
Christ College ATM,29-11-2014,202,59,143,990900,342400,648500,SATURDAY,NH,H,WHH
Christ College ATM,30-11-2014,163,50,113,726600,273500,453100,SUNDAY,NH,H,HHW
Christ College ATM,01-12-2014,183,61,122,1004600,334600,670000,MONDAY,NH,W,HWW
Christ College ATM,02-12-2014,149,57,92,848500,288100,560400,TUESDAY,NH,W,WWW
Christ College ATM,03-12-2014,179,73,106,1039900,484000,555900,WEDNESDAY,NH,W,WWW
Christ College ATM,04-12-2014,159,71,88,725900,368000,357900,THURSDAY,NH,W,WWW
Christ College ATM,05-12-2014,172,77,95,844200,379300,464900,FRIDAY,NH,W,WWH
Christ College ATM,06-12-2014,193,88,105,958800,471000,487800,SATURDAY,NH,H,WHH
Christ College ATM,07-12-2014,124,45,79,447000,153400,293600,SUNDAY,NH,H,HHW
Christ College ATM,08-12-2014,124,45,79,526100,230700,295400,MONDAY,NH,W,HWW
Christ College ATM,09-12-2014,166,57,109,742500,266100,476400,TUESDAY,NH,W,WWW
Christ College ATM,10-12-2014,141,53,88,627600,278900,348700,WEDNESDAY,NH,W,WWW
Christ College ATM,11-12-2014,125,62,63,514400,286400,228000,THURSDAY,NH,W,WWW
Christ College ATM,12-12-2014,107,46,61,456600,259500,197100,FRIDAY,NH,W,WWH
Christ College ATM,13-12-2014,117,55,62,531500,332700,198800,SATURDAY,NH,H,WHH
Christ College ATM,14-12-2014,77,29,48,265200,117700,147500,SUNDAY,NH,H,HHW
Christ College ATM,15-12-2014,119,56,63,500500,240900,259600,MONDAY,NH,W,HWW
Christ College ATM,16-12-2014,102,52,50,369900,188600,181300,TUESDAY,NH,W,WWW
Christ College ATM,17-12-2014,114,50,64,553000,341600,211400,WEDNESDAY,NH,W,WWW
Christ College ATM,18-12-2014,123,50,73,435500,236700,198800,THURSDAY,NH,W,WWW
Christ College ATM,19-12-2014,99,45,54,337100,206300,130800,FRIDAY,NH,W,WWH
Christ College ATM,20-12-2014,115,61,54,502100,281700,220400,SATURDAY,NH,H,WHH
Christ College ATM,21-12-2014,132,54,78,416900,171500,245400,SUNDAY,NH,H,HHW
Christ College ATM,22-12-2014,148,55,93,556300,277900,278400,MONDAY,NH,W,HWW
Christ College ATM,23-12-2014,93,39,54,320200,186000,134200,TUESDAY,NH,W,WWW
Christ College ATM,24-12-2014,176,53,123,760900,299600,461300,WEDNESDAY,NH,W,WWH
Christ College ATM,25-12-2014,163,49,114,433900,163800,270100,THURSDAY,C,H,WHW
Christ College ATM,26-12-2014,91,40,51,288400,155000,133400,FRIDAY,NH,W,HWH
Christ College ATM,27-12-2014,114,51,63,487700,278700,209000,SATURDAY,NH,H,WHH
Christ College ATM,28-12-2014,86,29,57,317000,116800,200200,SUNDAY,NH,H,HHW
Christ College ATM,29-12-2014,113,67,46,512300,330400,181900,MONDAY,NH,W,HWW
Christ College ATM,30-12-2014,110,50,60,557400,271900,285500,TUESDAY,NH,W,WWW
Christ College ATM,31-12-2014,165,75,90,698100,397400,300700,WEDNESDAY,NH,W,WWH
Christ College ATM,01-01-2015,134,54,80,722600,270800,451800,Thursday,C,H,WHW
Christ College ATM,02-01-2015,186,64,122,832900,306300,526600,Friday,NH,W,HWH
Christ College ATM,03-01-2015,169,89,80,877200,453400,423800,Saturday,NH,H,WHH
Christ College ATM,04-01-2015,55,18,37,198700,57000,141700,Sunday,M,H,HHW
Christ College ATM,05-01-2015,211,84,127,1153800,467900,685900,Monday,NH,W,HWW
Christ College ATM,06-01-2015,152,70,82,607900,309300,298600,Tuesday,NH,W,WWW
Christ College ATM,07-01-2015,128,60,68,563900,282600,281300,Wednesday,NH,W,WWW
Christ College ATM,08-01-2015,143,76,67,770200,473800,296400,Thursday,NH,W,WWW
Christ College ATM,09-01-2015,131,78,53,697000,410200,286800,Friday,NH,W,WWH
Christ College ATM,10-01-2015,219,73,146,1066100,504100,562000,Saturday,NH,H,WHH
Christ College ATM,11-01-2015,158,50,108,492000,162800,329200,Sunday,NH,H,HHW
Christ College ATM,12-01-2015,137,62,75,564300,357400,206900,Monday,NH,W,HWW
Christ College ATM,13-01-2015,135,79,56,765000,544400,220600,Tuesday,NH,W,WWW
Christ College ATM,14-01-2015,141,90,51,678400,551300,127100,Wednesday,NH,W,WWH
Christ College ATM,15-01-2015,70,33,37,176800,82100,94700,Thursday,H,H,WHH
Christ College ATM,16-01-2015,53,25,28,235800,146100,89700,Friday,N,H,HHH
Christ College ATM,17-01-2015,97,41,56,236000,106600,129400,Saturday,H,H,HHH
Christ College ATM,18-01-2015,100,49,51,375000,260400,114600,Sunday,NH,H,HHW
Christ College ATM,19-01-2015,168,81,87,811100,455400,355700,Monday,NH,W,HWW
Christ College ATM,20-01-2015,133,57,76,501600,169200,332400,Tuesday,NH,W,WWW
Christ College ATM,21-01-2015,98,54,44,391400,249200,142200,Wednesday,NH,W,WWW
Christ College ATM,22-01-2015,129,66,63,602900,390000,212900,Thursday,NH,W,WWW
Christ College ATM,23-01-2015,112,52,60,540100,341200,198900,Friday,NH,W,WWH
Christ College ATM,24-01-2015,146,63,83,691700,386800,304900,Saturday,NH,H,WHH
Christ College ATM,25-01-2015,94,40,54,329200,134600,194600,Sunday,NH,H,HHH
Christ College ATM,26-01-2015,83,32,51,244800,108900,135900,Monday,N,H,HHW
Christ College ATM,27-01-2015,94,46,48,411100,208200,202900,Tuesday,NH,W,HWW
Christ College ATM,28-01-2015,111,52,59,551700,317500,234200,Wednesday,NH,W,WWW
Christ College ATM,29-01-2015,94,40,54,395700,195700,200000,Thursday,NH,W,WWW
Christ College ATM,30-01-2015,96,51,45,402700,281400,121300,Friday,NH,W,WWH
Christ College ATM,31-01-2015,225,62,163,938500,338900,599600,Saturday,NH,H,WHH
Christ College ATM,01-02-2015,177,45,132,775200,239800,535400,Sunday,NH,H,HHW
Christ College ATM,02-02-2015,159,71,88,788900,368700,420200,Monday,NH,W,HWW
Christ College ATM,03-02-2015,174,72,102,1001800,467000,534800,Tuesday,NH,W,WWW
Christ College ATM,04-02-2015,110,49,61,552200,212500,339700,Wednesday,NH,W,WWW
Christ College ATM,05-02-2015,149,60,89,691900,298200,393700,Thursday,NH,W,WWW
Christ College ATM,06-02-2015,126,61,65,636900,319700,317200,Friday,NH,W,WWH
Christ College ATM,07-02-2015,144,70,74,676000,354600,321400,Saturday,NH,H,WHH
Christ College ATM,08-02-2015,131,51,80,620800,313000,307800,Sunday,NH,H,HHW
Christ College ATM,09-02-2015,172,58,114,781000,315100,465900,Monday,NH,W,HWW
Christ College ATM,10-02-2015,119,66,53,527400,333600,193800,Tuesday,NH,W,WWW
Christ College ATM,11-02-2015,144,55,89,588900,307800,281100,Wednesday,NH,W,WWW
Christ College ATM,12-02-2015,154,66,88,644700,277100,367600,Thursday,NH,W,WWW
Christ College ATM,13-02-2015,208,59,149,575500,197400,378100,Friday,NH,W,WWH
Christ College ATM,14-02-2015,225,86,139,981800,483600,498200,Saturday,NH,H,WHH
Christ College ATM,15-02-2015,245,52,193,754400,228100,526300,Sunday,NH,H,HHW
Christ College ATM,16-02-2015,111,52,59,602900,415700,187200,Monday,NH,W,HWW
Christ College ATM,18-02-2015,38,20,18,115900,86900,29000,Wednesday,NH,W,WWW
Christ College ATM,19-02-2015,97,54,43,385200,231200,154000,Thursday,NH,W,WWW
Christ College ATM,20-02-2015,99,62,37,434500,336100,98400,Friday,NH,W,WWH
Christ College ATM,21-02-2015,129,74,55,662800,441100,221700,Saturday,NH,H,WHH
Christ College ATM,22-02-2015,101,45,56,269700,146600,123100,Sunday,NH,H,HHW
Christ College ATM,23-02-2015,91,45,46,340900,166500,174400,Monday,NH,W,HWW
Christ College ATM,24-02-2015,88,49,39,317400,205000,112400,Tuesday,NH,W,WWW
Christ College ATM,25-02-2015,106,54,52,466000,318600,147400,Wednesday,NH,W,WWW
Christ College ATM,26-02-2015,96,51,45,402300,242500,159800,Thursday,NH,W,WWW
Christ College ATM,27-02-2015,126,73,53,620100,456500,163600,Friday,NH,W,WWH
Christ College ATM,28-02-2015,127,57,70,641400,343000,298400,Saturday,NH,H,WHH
Christ College ATM,01-03-2015,130,59,71,473800,200800,273000,Sunday,NH,H,HHW
Christ College ATM,02-03-2015,148,68,80,606900,307300,299600,Monday,NH,W,HWW
Christ College ATM,03-03-2015,153,73,80,632600,292200,340400,Tuesday,NH,W,WWW
Christ College ATM,04-03-2015,147,72,75,737900,333900,404000,Wednesday,NH,W,WWW
Christ College ATM,05-03-2015,172,89,83,896500,548400,348100,Thursday,NH,W,WWW
Christ College ATM,06-03-2015,139,65,74,653000,295000,358000,Friday,NH,W,WWH
Christ College ATM,07-03-2015,131,67,64,712000,406000,306000,Saturday,NH,H,WHH
Christ College ATM,08-03-2015,112,50,62,490800,223500,267300,Sunday,NH,H,HHW
Christ College ATM,09-03-2015,119,66,53,561800,320800,241000,Monday,NH,W,HWW
Christ College ATM,10-03-2015,132,54,78,631900,269000,362900,Tuesday,NH,W,WWW
Christ College ATM,11-03-2015,103,57,46,456900,303100,153800,Wednesday,NH,W,WWW
Christ College ATM,12-03-2015,185,62,123,682800,307100,375700,Thursday,NH,W,WWW
Christ College ATM,13-03-2015,209,66,143,856400,396100,460300,Friday,NH,W,WWH
Christ College ATM,14-03-2015,184,73,111,769000,329900,439100,Saturday,NH,H,WHH
Christ College ATM,15-03-2015,75,42,33,209300,139600,69700,Sunday,NH,H,HHW
Christ College ATM,16-03-2015,126,66,60,618200,401800,216400,Monday,NH,W,HWW
Christ College ATM,17-03-2015,104,54,50,373600,221500,152100,Tuesday,NH,W,WWW
Christ College ATM,18-03-2015,110,58,52,449700,339700,110000,Wednesday,NH,W,WWW
Christ College ATM,19-03-2015,114,53,61,462500,297200,165300,Thursday,NH,W,WWW
Christ College ATM,20-03-2015,115,54,61,427900,241300,186600,Friday,NH,W,WWH
Christ College ATM,21-03-2015,142,60,82,765000,477700,287300,Saturday,H,H,WHH
Christ College ATM,22-03-2015,150,39,111,508600,125100,383500,Sunday,NH,H,HHW
Christ College ATM,23-03-2015,151,61,90,568900,287400,281500,Monday,NH,W,HWW
Christ College ATM,24-03-2015,132,64,68,448500,258700,189800,Tuesday,NH,W,WWW
Christ College ATM,25-03-2015,125,62,63,529200,366400,162800,Wednesday,NH,W,WWW
Christ College ATM,26-03-2015,106,44,62,496000,235300,260700,Thursday,NH,W,WWW
Christ College ATM,27-03-2015,145,69,76,701000,443500,257500,Friday,NH,W,WWH
Christ College ATM,28-03-2015,117,58,59,527200,371700,155500,Saturday,NH,H,WHH
Christ College ATM,29-03-2015,102,48,54,321500,180900,140600,Sunday,NH,H,HHW
Christ College ATM,30-03-2015,132,74,58,534100,387900,146200,Monday,NH,W,HWW
Christ College ATM,31-03-2015,89,45,44,452700,203800,248900,Tuesday,NH,W,WWW
Christ College ATM,01-04-2015,144,62,82,645100,293200,351900,Wednesday,NH,W,WWH
Christ College ATM,02-04-2015,141,48,93,661300,225400,435900,Thursday,H,H,WHH
Christ College ATM,03-04-2015,138,50,88,597400,242300,355100,Friday,C,H,HHH
Christ College ATM,04-04-2015,102,36,66,398800,177000,221800,Saturday,NH,H,HHH
Christ College ATM,05-04-2015,99,34,65,390600,169100,221500,Sunday,NH,H,HHW
Christ College ATM,06-04-2015,203,82,121,1052900,468300,584600,Monday,NH,W,HWW
Christ College ATM,07-04-2015,146,63,83,602300,242600,359700,Tuesday,NH,W,WWW
Christ College ATM,08-04-2015,139,59,80,661200,325700,335500,Wednesday,NH,W,WWW
Christ College ATM,09-04-2015,143,70,73,725300,337100,388200,Thursday,NH,W,WWW
Christ College ATM,10-04-2015,119,58,61,572900,346400,226500,Friday,NH,W,WWH
Christ College ATM,11-04-2015,147,54,93,686600,373400,313200,Saturday,NH,H,WHH
Christ College ATM,12-04-2015,137,53,84,509100,204600,304500,Sunday,NH,H,HHW
Christ College ATM,13-04-2015,168,69,99,902600,412700,489900,Monday,NH,W,HWH
Christ College ATM,14-04-2015,92,42,50,399200,226000,173200,Tuesday,H,H,WHW
Christ College ATM,15-04-2015,151,72,79,800600,439800,360800,Wednesday,NH,W,HWW
Christ College ATM,16-04-2015,126,66,60,668300,393800,274500,Thursday,NH,W,WWW
Christ College ATM,17-04-2015,76,48,28,380700,262800,117900,Friday,NH,W,WWH
Christ College ATM,18-04-2015,128,51,77,555800,273300,282500,Saturday,NH,H,WHH
Christ College ATM,19-04-2015,85,32,53,263200,110300,152900,Sunday,NH,H,HHW
Christ College ATM,20-04-2015,119,51,68,539900,249100,290800,Monday,NH,W,HWW
Christ College ATM,21-04-2015,118,69,49,468700,266700,202000,Tuesday,NH,W,WWW
Christ College ATM,22-04-2015,130,48,82,483200,188300,294900,Wednesday,NH,W,WWW
Christ College ATM,23-04-2015,134,35,99,666900,166100,500800,Thursday,NH,W,WWW
Christ College ATM,24-04-2015,161,48,113,652600,290100,362500,Friday,NH,W,WWH
Christ College ATM,25-04-2015,186,57,129,825400,298100,527300,Saturday,NH,H,WHH
Christ College ATM,26-04-2015,179,37,142,659600,157000,502600,Sunday,NH,H,HHW
Christ College ATM,27-04-2015,200,54,146,796600,334300,462300,Monday,NH,W,HWW
Christ College ATM,28-04-2015,214,65,149,804200,274100,530100,Tuesday,NH,W,WWW
Christ College ATM,29-04-2015,134,64,70,567700,358800,208900,Wednesday,NH,W,WWW
Christ College ATM,30-04-2015,151,66,85,608700,349800,258900,Thursday,NH,W,WWH
Christ College ATM,01-05-2015,100,36,64,445100,180700,264400,Friday,N,H,WHH
Christ College ATM,02-05-2015,288,74,214,1569200,455700,1113500,Saturday,NH,H,HHH
Christ College ATM,03-05-2015,156,39,117,560800,126000,434800,Sunday,NH,H,HHW
Christ College ATM,04-05-2015,184,59,125,1002800,349600,653200,Monday,NH,W,HWW
Christ College ATM,05-05-2015,163,89,74,856200,577100,279100,Tuesday,NH,W,WWW
Christ College ATM,06-05-2015,136,73,63,708100,444900,263200,Wednesday,NH,W,WWW
Christ College ATM,07-05-2015,178,64,114,883100,353800,529300,Thursday,NH,W,WWW
Christ College ATM,08-05-2015,131,60,71,638600,346200,292400,Friday,NH,W,WWH
Christ College ATM,09-05-2015,125,81,44,719200,539000,180200,Saturday,NH,H,WHH
Christ College ATM,10-05-2015,104,36,68,472000,159400,312600,Sunday,NH,H,HHW
Christ College ATM,11-05-2015,147,60,87,663300,324900,338400,Monday,NH,W,HWW
Christ College ATM,12-05-2015,139,49,90,498000,163300,334700,Tuesday,NH,W,WWW
Christ College ATM,13-05-2015,142,49,93,583400,191000,392400,Wednesday,NH,W,WWW
Christ College ATM,14-05-2015,101,43,58,312600,137800,174800,Thursday,NH,W,WWW
Christ College ATM,15-05-2015,134,73,61,660900,461700,199200,Friday,NH,W,WWH
Christ College ATM,16-05-2015,104,57,47,462000,322000,140000,Saturday,NH,H,WHH
Christ College ATM,17-05-2015,74,36,38,237900,92600,145300,Sunday,NH,H,HHW
Christ College ATM,18-05-2015,108,55,53,591600,379100,212500,Monday,NH,W,HWW
Christ College ATM,19-05-2015,123,65,58,557800,334800,223000,Tuesday,NH,W,WWW
Christ College ATM,20-05-2015,113,54,59,612300,382100,230200,Wednesday,NH,W,WWW
Christ College ATM,21-05-2015,118,58,60,529400,317900,211500,Thursday,NH,W,WWW
Christ College ATM,22-05-2015,113,59,54,495400,309800,185600,Friday,NH,W,WWH
Christ College ATM,23-05-2015,169,57,112,713200,333600,379600,Saturday,NH,H,WHH
Christ College ATM,24-05-2015,137,36,101,490000,141200,348800,Sunday,NH,H,HHW
Christ College ATM,25-05-2015,113,47,66,500200,235400,264800,Monday,NH,W,HWW
Christ College ATM,26-05-2015,109,55,54,485400,273800,211600,Tuesday,NH,W,WWW
Christ College ATM,27-05-2015,124,63,61,602900,358500,244400,Wednesday,NH,W,WWW
Christ College ATM,28-05-2015,134,42,92,569500,217300,352200,Thursday,NH,W,WWW
Christ College ATM,29-05-2015,109,34,75,509900,147300,362600,Friday,NH,W,WWH
Christ College ATM,30-05-2015,125,52,73,582800,291100,291700,Saturday,NH,H,WHH
Christ College ATM,31-05-2015,102,36,66,477900,179800,298100,Sunday,NH,H,HHW
Christ College ATM,01-06-2015,45,19,26,237300,82000,155300,Monday,NH,W,HWW
Christ College ATM,02-06-2015,93,45,48,467500,231300,236200,Tuesday,NH,W,WWW
Christ College ATM,03-06-2015,145,58,87,731900,271000,460900,Wednesday,NH,W,WWW
Christ College ATM,04-06-2015,228,82,146,1072900,394400,678500,Thursday,NH,W,WWW
Christ College ATM,05-06-2015,167,84,83,664200,359300,304900,Friday,NH,W,WWH
Christ College ATM,06-06-2015,186,77,109,955900,482400,473500,Saturday,NH,H,WHH
Christ College ATM,07-06-2015,37,12,25,71100,23600,47500,Sunday,NH,H,HHW
Christ College ATM,08-06-2015,115,48,67,560900,255400,305500,Monday,NH,W,HWW
Christ College ATM,09-06-2015,128,56,72,668200,367100,301100,Tuesday,NH,W,WWW
Christ College ATM,10-06-2015,137,67,70,489000,276200,212800,Wednesday,NH,W,WWW
Christ College ATM,11-06-2015,115,52,63,430700,203200,227500,Thursday,NH,W,WWW
Christ College ATM,12-06-2015,119,48,71,413200,140900,272300,Friday,NH,W,WWH
Christ College ATM,13-06-2015,166,70,96,762200,387500,374700,Saturday,NH,H,WHH
Christ College ATM,14-06-2015,94,37,57,239800,93100,146700,Sunday,NH,H,HHW
Christ College ATM,15-06-2015,133,69,64,654300,402800,251500,Monday,NH,W,HWW
Christ College ATM,16-06-2015,111,60,51,407000,236000,171000,Tuesday,NH,W,WWW
Christ College ATM,17-06-2015,113,45,68,573900,282000,291900,Wednesday,NH,W,WWW
Christ College ATM,18-06-2015,113,57,56,558500,344800,213700,Thursday,NH,W,WWW
Christ College ATM,19-06-2015,160,52,108,554400,188000,366400,Friday,NH,W,WWH
Christ College ATM,20-06-2015,155,68,87,637600,345700,291900,Saturday,NH,H,WHH
Christ College ATM,21-06-2015,158,50,108,484400,198100,286300,Sunday,NH,H,HHW
Christ College ATM,22-06-2015,156,64,92,569500,283800,285700,Monday,NH,W,HWW
Christ College ATM,23-06-2015,127,46,81,369900,182400,187500,Tuesday,NH,W,WWW
Christ College ATM,24-06-2015,154,67,87,827700,419900,407800,Wednesday,NH,W,WWW
Christ College ATM,25-06-2015,154,57,97,566800,230000,336800,Thursday,NH,W,WWW
Christ College ATM,26-06-2015,109,60,49,394800,278700,116100,Friday,NH,W,WWH
Christ College ATM,27-06-2015,135,61,74,713200,394500,318700,Saturday,NH,H,WHH
Christ College ATM,28-06-2015,110,49,61,339400,177500,161900,Sunday,NH,H,HHW
Christ College ATM,29-06-2015,124,55,69,473000,251600,221400,Monday,NH,W,HWW
Christ College ATM,30-06-2015,161,71,90,733300,415600,317700,Tuesday,NH,W,WWW
Christ College ATM,01-07-2015,196,63,133,870000,302600,567400,Wednesday,NH,W,WWW
Christ College ATM,02-07-2015,182,54,128,902700,248200,654500,Thursday,NH,W,WWW
Christ College ATM,03-07-2015,148,51,97,642800,242800,400000,Friday,NH,W,WWH
Christ College ATM,04-07-2015,38,23,15,175100,119400,55700,Saturday,NH,H,WHH
Christ College ATM,06-07-2015,133,46,87,707700,246100,461600,Monday,NH,W,HWW
Christ College ATM,07-07-2015,149,84,65,687300,355900,331400,Tuesday,NH,W,WWW
Christ College ATM,08-07-2015,109,59,50,555300,298500,256800,Wednesday,NH,W,WWW
Christ College ATM,09-07-2015,126,64,62,500700,274900,225800,Thursday,NH,W,WWW
Christ College ATM,10-07-2015,146,59,87,671900,329700,342200,Friday,NH,W,WWH
Christ College ATM,11-07-2015,194,74,120,870000,380400,489600,Saturday,NH,H,WHH
Christ College ATM,12-07-2015,104,59,45,258700,158100,100600,Sunday,NH,H,HHW
Christ College ATM,13-07-2015,109,48,61,452000,229500,222500,Monday,NH,W,HWW
Christ College ATM,14-07-2015,135,60,75,608600,265000,343600,Tuesday,NH,W,WWW
Christ College ATM,15-07-2015,130,63,67,709600,401700,307900,Wednesday,NH,W,WWW
Christ College ATM,16-07-2015,125,65,60,676100,496800,179300,Thursday,NH,W,WWW
Christ College ATM,17-07-2015,89,44,45,372400,215000,157400,Friday,NH,W,WWH
Christ College ATM,20-07-2015,174,58,116,907800,283600,624200,Monday,NH,W,HWW
Christ College ATM,21-07-2015,130,62,68,521500,266300,255200,Tuesday,NH,W,WWW
Christ College ATM,22-07-2015,123,48,75,410300,155800,254500,Wednesday,NH,W,WWW
Christ College ATM,23-07-2015,132,55,77,589800,274400,315400,Thursday,NH,W,WWW
Christ College ATM,24-07-2015,108,45,63,307900,135900,172000,Friday,NH,W,WWH
Christ College ATM,25-07-2015,144,72,72,653200,476600,176600,Saturday,NH,H,WHH
Christ College ATM,26-07-2015,107,43,64,370800,204200,166600,Sunday,NH,H,HHW
Christ College ATM,27-07-2015,95,38,57,332500,170400,162100,Monday,NH,W,HWW
Christ College ATM,28-07-2015,106,56,50,478300,300300,178000,Tuesday,NH,W,WWW
Christ College ATM,29-07-2015,127,63,64,568800,372900,195900,Wednesday,NH,W,WWW
Christ College ATM,30-07-2015,67,34,33,241100,168700,72400,Thursday,NH,W,WWH
Christ College ATM,31-07-2015,141,65,76,647100,323100,324000,Friday,NH,W,WWH
Christ College ATM,01-08-2015,197,77,120,990400,359700,630700,Saturday,NH,H,WHH
Christ College ATM,02-08-2015,29,6,23,110600,60700,49900,Sunday,NH,H,HHW
Christ College ATM,03-08-2015,88,21,67,393600,107000,286600,Monday,NH,W,HWW
Christ College ATM,04-08-2015,142,71,71,688700,381500,307200,Tuesday,NH,W,WWW
Christ College ATM,05-08-2015,35,22,13,229600,175700,53900,Wednesday,NH,W,WWW
Christ College ATM,06-08-2015,46,17,29,140100,62300,77800,Thursday,NH,W,WWW
Christ College ATM,07-08-2015,140,60,80,540900,257000,283900,Friday,NH,W,WWH
Christ College ATM,08-08-2015,160,86,74,950300,635000,315300,Saturday,NH,H,WHH
Christ College ATM,09-08-2015,33,14,19,121400,95000,26400,Sunday,NH,H,HHW
Christ College ATM,10-08-2015,127,44,83,489300,136600,352700,Monday,NH,W,HWW
Christ College ATM,11-08-2015,126,64,62,579400,366600,212800,Tuesday,NH,W,WWW
Christ College ATM,12-08-2015,128,65,63,499800,312500,187300,Wednesday,NH,W,WWW
Christ College ATM,13-08-2015,106,48,58,457100,266300,190800,Thursday,NH,W,WWW
Christ College ATM,14-08-2015,119,51,68,595600,308400,287200,Friday,NH,W,WWH
Christ College ATM,15-08-2015,87,43,44,275400,159300,116100,Saturday,N,H,WHH
Christ College ATM,16-08-2015,106,36,70,232600,87100,145500,Sunday,NH,H,HHW
Christ College ATM,17-08-2015,114,56,58,552200,326300,225900,Monday,NH,W,HWW
Christ College ATM,18-08-2015,140,58,82,599500,339800,259700,Tuesday,NH,W,WWW
Christ College ATM,19-08-2015,149,72,77,574600,291300,283300,Wednesday,NH,W,WWW
Christ College ATM,20-08-2015,137,53,84,498900,205100,293800,Thursday,NH,W,WWW
Christ College ATM,21-08-2015,191,57,134,741600,323700,417900,Friday,NH,W,WWH
Christ College ATM,22-08-2015,160,48,112,571600,173400,398200,Saturday,NH,H,WHH
Christ College ATM,23-08-2015,78,38,40,239800,118600,121200,Sunday,NH,H,HHW
Christ College ATM,24-08-2015,96,48,48,273600,171700,101900,Monday,NH,W,HWW
Christ College ATM,25-08-2015,138,42,96,411400,111400,300000,Tuesday,NH,W,WWW
Christ College ATM,26-08-2015,124,50,74,423800,189700,234100,Wednesday,NH,W,WWW
Christ College ATM,27-08-2015,124,49,75,537300,265000,272300,Thursday,NH,W,WWW
Christ College ATM,28-08-2015,100,44,56,371900,179000,192900,Friday,NH,W,WWH
Christ College ATM,29-08-2015,130,56,74,495800,251200,244600,Saturday,NH,H,WHH
Christ College ATM,30-08-2015,91,39,52,346900,213100,133800,Sunday,NH,H,HHW
Christ College ATM,31-08-2015,123,63,60,473900,245700,228200,Monday,NH,W,HWW
Christ College ATM,01-09-2015,146,56,90,783000,313600,469400,Tuesday,NH,W,WWW
Christ College ATM,02-09-2015,144,64,80,828800,404700,424100,Wednesday,NH,W,WWW
Christ College ATM,03-09-2015,152,65,87,799000,374300,424700,Thursday,NH,W,WWW
Christ College ATM,04-09-2015,178,76,102,823800,416200,407600,Friday,NH,W,WWH
Christ College ATM,05-09-2015,239,64,175,1235900,482900,753000,Saturday,H,H,WHH
Christ College ATM,06-09-2015,90,16,74,211800,33200,178600,Sunday,NH,H,HHW
Christ College ATM,07-09-2015,131,44,87,598200,242200,356000,Monday,NH,W,HWW
Christ College ATM,08-09-2015,197,72,125,978100,358200,619900,Tuesday,NH,W,WWW
Christ College ATM,09-09-2015,147,62,85,657300,336900,320400,Wednesday,NH,W,WWW
Christ College ATM,10-09-2015,168,69,99,762300,368600,393700,Thursday,NH,W,WWW
Christ College ATM,11-09-2015,132,74,58,695700,466200,229500,Friday,NH,W,WWH
Christ College ATM,12-09-2015,120,65,55,687300,472600,214700,Saturday,NH,H,WHH
Christ College ATM,13-09-2015,128,47,81,661100,334100,327000,Sunday,NH,H,HHW
Christ College ATM,14-09-2015,37,18,19,225100,144900,80200,Monday,NH,W,HWW
Christ College ATM,15-09-2015,137,63,74,600300,326300,274000,Tuesday,NH,W,WWW
Christ College ATM,16-09-2015,121,56,65,426100,202200,223900,Wednesday,NH,W,WWH
Christ College ATM,17-09-2015,69,35,34,283900,177800,106100,Thursday,H,H,WHW
Christ College ATM,18-09-2015,120,51,69,429200,215000,214200,Friday,NH,W,HWH
Christ College ATM,19-09-2015,119,48,71,512800,259900,252900,Saturday,NH,H,WHH
Christ College ATM,20-09-2015,101,43,58,338500,151200,187300,Sunday,NH,H,HHW
Christ College ATM,21-09-2015,144,63,81,574200,254600,319600,Monday,NH,W,HWW
Christ College ATM,22-09-2015,127,54,73,557000,214500,342500,Tuesday,NH,W,WWW
Christ College ATM,23-09-2015,91,48,43,325100,214200,110900,Wednesday,NH,W,WWH
Christ College ATM,24-09-2015,97,42,55,343500,190600,152900,Thursday,M,H,WHW
Christ College ATM,25-09-2015,103,48,55,380700,220900,159800,Friday,NH,W,HWH
Christ College ATM,26-09-2015,126,48,78,525100,210500,314600,Saturday,NH,H,WHH
Christ College ATM,27-09-2015,82,41,41,190100,90500,99600,Sunday,NH,H,HHW
Christ College ATM,28-09-2015,132,66,66,597100,335900,261200,Monday,NH,W,HWW
Christ College ATM,29-09-2015,124,65,59,603500,400900,202600,Tuesday,NH,W,WWW
Christ College ATM,30-09-2015,116,56,60,674800,340000,334800,Wednesday,NH,W,WWW
Christ College ATM,01-10-2015,161,69,92,917200,409500,507700,Thursday,NH,W,WWH
Christ College ATM,02-10-2015,109,47,62,520700,227500,293200,Friday,N,H,WHH
Christ College ATM,03-10-2015,130,57,73,739200,365100,374100,Saturday,NH,H,HHH
Christ College ATM,04-10-2015,129,48,81,633600,307600,326000,Sunday,NH,H,HHW
Christ College ATM,05-10-2015,165,52,113,845100,267900,577200,Monday,NH,W,HWW
Christ College ATM,06-10-2015,186,74,112,960500,491300,469200,Tuesday,NH,W,WWW
Christ College ATM,07-10-2015,188,84,104,1024600,498300,526300,Wednesday,NH,W,WWW
Christ College ATM,08-10-2015,112,62,50,540400,292600,247800,Thursday,NH,W,WWW
Christ College ATM,09-10-2015,116,60,56,580100,359600,220500,Friday,NH,W,WWH
Christ College ATM,10-10-2015,118,61,57,516000,347400,168600,Saturday,NH,H,WHH
Christ College ATM,11-10-2015,101,38,63,342000,162400,179600,Sunday,NH,H,HHW
Christ College ATM,12-10-2015,141,44,97,565400,188000,377400,Monday,NH,W,HWW
Christ College ATM,13-10-2015,24,12,12,51500,23000,28500,Tuesday,NH,W,WWW
Christ College ATM,14-10-2015,146,61,85,645400,396600,248800,Wednesday,NH,W,WWW
Christ College ATM,15-10-2015,140,83,57,735200,514000,221200,Thursday,NH,W,WWW
Christ College ATM,16-10-2015,112,51,61,415400,228500,186900,Friday,NH,W,WWH
Christ College ATM,17-10-2015,154,76,78,858900,551800,307100,Saturday,NH,H,WHH
Christ College ATM,18-10-2015,61,39,22,121500,90400,31100,Sunday,NH,H,HHW
Christ College ATM,19-10-2015,127,54,73,381800,202900,178900,Monday,NH,W,HWW
Christ College ATM,20-10-2015,149,82,67,786900,517800,269100,Tuesday,NH,W,WWH
Christ College ATM,21-10-2015,93,37,56,300000,148100,151900,Wednesday,H,H,WHH
Christ College ATM,22-10-2015,54,15,39,69600,16700,52900,Thursday,H,H,HHH
Christ College ATM,23-10-2015,81,45,36,397900,286800,111100,Friday,M,H,HHH
Christ College ATM,24-10-2015,127,49,78,502600,170400,332200,Saturday,NH,H,HHH
Christ College ATM,25-10-2015,98,43,55,248900,130300,118600,Sunday,NH,H,HHW
Christ College ATM,26-10-2015,103,46,57,380500,212000,168500,Monday,NH,W,HWW
Christ College ATM,27-10-2015,90,40,50,343000,182600,160400,Tuesday,NH,W,WWW
Christ College ATM,28-10-2015,149,73,76,549500,287000,262500,Wednesday,NH,W,WWW
Christ College ATM,29-10-2015,98,54,44,454200,281200,173000,Thursday,NH,W,WWW
Christ College ATM,30-10-2015,130,72,58,717000,443600,273400,Friday,NH,W,WWH
Christ College ATM,31-10-2015,101,57,44,607900,468600,139300,Saturday,NH,H,WHH
Christ College ATM,01-11-2015,2,2,0,3200,3200,0,Sunday,NH,H,HHW
Christ College ATM,02-11-2015,133,37,96,670800,199600,471200,Monday,NH,W,HWW
Christ College ATM,03-11-2015,169,83,86,946600,518500,428100,Tuesday,NH,W,WWW
Christ College ATM,04-11-2015,148,67,81,747800,376800,371000,Wednesday,NH,W,WWW
Christ College ATM,05-11-2015,154,65,89,655200,236600,418600,Thursday,NH,W,WWW
Christ College ATM,06-11-2015,178,84,94,739300,408900,330400,Friday,NH,W,WWH
Christ College ATM,07-11-2015,193,82,111,1096200,499100,597100,Saturday,NH,H,WHH
Christ College ATM,08-11-2015,50,29,21,106900,73800,33100,Sunday,NH,H,HHW
Christ College ATM,09-11-2015,68,26,42,469700,206700,263000,Monday,NH,W,HWH
Christ College ATM,10-11-2015,60,26,34,284600,141900,142700,Tuesday,H,H,WHW
Christ College ATM,11-11-2015,108,38,70,524400,206200,318200,Wednesday,NH,W,HWW
Christ College ATM,12-11-2015,141,43,98,559200,175400,383800,Thursday,NH,W,WWW
Christ College ATM,13-11-2015,134,42,92,513300,214600,298700,Friday,NH,W,WWH
Christ College ATM,14-11-2015,123,50,73,474000,247000,227000,Saturday,NH,H,WHH
Christ College ATM,15-11-2015,60,25,35,179400,103700,75700,Sunday,NH,H,HHW
Christ College ATM,16-11-2015,82,40,42,336700,182700,154000,Monday,NH,W,HWW
Christ College ATM,17-11-2015,142,56,86,749700,277900,471800,Tuesday,NH,W,WWW
Christ College ATM,18-11-2015,137,50,87,497400,212600,284800,Wednesday,NH,W,WWW
Christ College ATM,19-11-2015,126,60,66,501500,259200,242300,Thursday,NH,W,WWW
Christ College ATM,20-11-2015,116,41,75,434600,196400,238200,Friday,NH,W,WWH
Christ College ATM,21-11-2015,170,75,95,758200,421400,336800,Saturday,NH,H,WHH
Christ College ATM,22-11-2015,112,31,81,320700,119700,201000,Sunday,NH,H,HHH
Christ College ATM,23-11-2015,125,50,75,605000,402300,202700,Monday,M,H,HHW
Christ College ATM,24-11-2015,108,34,74,458800,156700,302100,Tuesday,NH,W,HWW
Christ College ATM,25-11-2015,157,57,100,592500,221100,371400,Wednesday,NH,W,WWW
Christ College ATM,26-11-2015,162,60,102,666800,296200,370600,Thursday,NH,W,WWW
Christ College ATM,27-11-2015,165,59,106,743500,336500,407000,Friday,NH,W,WWH
Christ College ATM,28-11-2015,138,58,80,385200,223800,161400,Saturday,NH,H,WHH
Christ College ATM,29-11-2015,3,3,0,1400,1400,0,Sunday,NH,H,HHW
Christ College ATM,30-11-2015,191,74,117,784500,290500,494000,Monday,NH,W,HWW
Christ College ATM,01-12-2015,189,100,89,990900,583600,407300,Tuesday,NH,W,WWW
Christ College ATM,02-12-2015,174,83,91,980700,570500,410200,Wednesday,NH,W,WWW
Christ College ATM,03-12-2015,155,61,94,758400,379500,378900,Thursday,NH,W,WWW
Christ College ATM,04-12-2015,173,60,113,782000,306600,475400,Friday,NH,W,WWH
Christ College ATM,05-12-2015,234,68,166,978600,356800,621800,Saturday,NH,H,WHH
Christ College ATM,06-12-2015,7,0,7,34000,0,34000,Sunday,NH,H,HHW
Christ College ATM,07-12-2015,158,60,98,694500,290900,403600,Monday,NH,W,HWW
Christ College ATM,08-12-2015,128,58,70,596900,357400,239500,Tuesday,NH,W,WWW
Christ College ATM,09-12-2015,132,65,67,634900,327300,307600,Wednesday,NH,W,WWW
Christ College ATM,10-12-2015,126,60,66,595000,371200,223800,Thursday,NH,W,WWW
Christ College ATM,11-12-2015,106,57,49,461700,363400,98300,Friday,NH,W,WWH
Christ College ATM,12-12-2015,152,58,94,590400,243000,347400,Saturday,NH,H,WHH
Christ College ATM,13-12-2015,164,43,121,445800,134300,311500,Sunday,NH,H,HHW
Christ College ATM,14-12-2015,169,60,109,490300,233900,256400,Monday,NH,W,HWW
Christ College ATM,15-12-2015,138,61,77,673300,348900,324400,Tuesday,NH,W,WWW
Christ College ATM,16-12-2015,135,74,61,693400,473900,219500,Wednesday,NH,W,WWW
Christ College ATM,17-12-2015,107,54,53,442500,283700,158800,Thursday,NH,W,WWW
Christ College ATM,18-12-2015,115,54,61,563100,294300,268800,Friday,NH,W,WWH
Christ College ATM,19-12-2015,124,54,70,550800,323700,227100,Saturday,NH,H,WHH
Christ College ATM,20-12-2015,119,57,62,422200,240700,181500,Sunday,NH,H,HHW
Christ College ATM,21-12-2015,134,74,60,520100,326900,193200,Monday,NH,W,HWW
Christ College ATM,22-12-2015,119,60,59,549900,268100,281800,Tuesday,NH,W,WWW
Christ College ATM,23-12-2015,127,63,64,648400,361300,287100,Wednesday,NH,W,WWW
Christ College ATM,24-12-2015,99,48,51,488100,304400,183700,Thursday,NH,W,WWH
Christ College ATM,25-12-2015,66,30,36,244800,138000,106800,Friday,C,H,WHH
Christ College ATM,26-12-2015,63,40,23,191100,129700,61400,Saturday,NH,H,HHH
Christ College ATM,27-12-2015,1,1,0,300,300,0,Sunday,NH,H,HHW
Christ College ATM,28-12-2015,111,55,56,507000,284400,222600,Monday,NH,W,HWW
Christ College ATM,29-12-2015,131,74,57,504600,271600,233000,Tuesday,NH,W,WWW
Christ College ATM,30-12-2015,146,79,67,703700,468400,235300,Wednesday,NH,W,WWW
Christ College ATM,31-12-2015,129,58,71,558400,336800,221600,Thursday,NH,W,WWH
Christ College ATM,01-01-2016,4,0,4,9100,0,9100,FRIDAY,C,H,WHH
Christ College ATM,02-01-2016,166,55,111,866800,385700,481100,SATURDAY,NH,H,HHH
Christ College ATM,03-01-2016,160,62,98,710300,319800,390500,SUNDAY,NH,H,HHW
Christ College ATM,04-01-2016,190,71,119,990300,460900,529400,MONDAY,NH,W,HWW
Christ College ATM,05-01-2016,136,61,75,682100,345000,337100,TUESDAY,NH,W,WWW
Christ College ATM,06-01-2016,202,90,112,1009700,446700,563000,WEDNESDAY,NH,W,WWW
Christ College ATM,07-01-2016,169,91,78,795700,555800,239900,THURSDAY,NH,W,WWW
Christ College ATM,08-01-2016,118,49,69,541200,307100,234100,FRIDAY,NH,W,WWH
Christ College ATM,09-01-2016,142,82,60,740600,523700,216900,SATURDAY,NH,H,WHH
Christ College ATM,10-01-2016,63,28,35,92000,32900,59100,SUNDAY,NH,H,HHW
Christ College ATM,11-01-2016,170,76,94,1031800,626200,405600,MONDAY,NH,W,HWW
Christ College ATM,12-01-2016,165,73,92,811100,475200,335900,TUESDAY,NH,W,WWW
Christ College ATM,13-01-2016,160,83,77,839300,583400,255900,WEDNESDAY,NH,W,WWW
Christ College ATM,14-01-2016,143,65,78,670800,423400,247400,THURSDAY,NH,W,WWH
Christ College ATM,15-01-2016,79,38,41,269100,146400,122700,FRIDAY,H,H,WHH
Christ College ATM,16-01-2016,73,38,35,273200,149500,123700,SATURDAY,H,H,HHH
Christ College ATM,17-01-2016,76,34,42,135700,74600,61100,SUNDAY,H,H,HHW
Christ College ATM,18-01-2016,129,56,73,479400,195800,283600,MONDAY,NH,W,HWW
Christ College ATM,19-01-2016,130,73,57,654400,455300,199100,TUESDAY,NH,W,WWW
Christ College ATM,20-01-2016,143,61,82,652400,393100,259300,WEDNESDAY,NH,W,WWW
Christ College ATM,21-01-2016,138,57,81,713100,308700,404400,THURSDAY,NH,W,WWW
Christ College ATM,22-01-2016,98,34,64,431700,188500,243200,FRIDAY,NH,W,WWH
Christ College ATM,23-01-2016,133,70,63,581200,389900,191300,SATURDAY,NH,H,WHH
Christ College ATM,24-01-2016,93,27,66,259500,73700,185800,SUNDAY,NH,H,HHW
Christ College ATM,25-01-2016,125,62,63,487400,227700,259700,MONDAY,NH,W,HWH
Christ College ATM,26-01-2016,93,50,43,387200,278200,109000,TUESDAY,N,H,WHW
Christ College ATM,27-01-2016,100,52,48,447100,328100,119000,WEDNESDAY,NH,W,HWW
Christ College ATM,28-01-2016,139,65,74,559900,366500,193400,THURSDAY,NH,W,WWW
Christ College ATM,29-01-2016,109,59,50,486400,349000,137400,FRIDAY,NH,W,WWH
Christ College ATM,30-01-2016,157,85,72,783200,532100,251100,SATURDAY,NH,H,WHH
Christ College ATM,31-01-2016,117,46,71,456300,242800,213500,SUNDAY,NH,H,HHW
Christ College ATM,01-02-2016,123,57,66,655000,315700,339300,MONDAY,NH,W,HWW
Christ College ATM,02-02-2016,152,83,69,711100,486100,225000,TUESDAY,NH,W,WWW
Christ College ATM,03-02-2016,149,81,68,1010700,648800,361900,WEDNESDAY,NH,W,WWW
Christ College ATM,04-02-2016,147,79,68,731100,448800,282300,THURSDAY,NH,W,WWW
Christ College ATM,05-02-2016,186,77,109,875100,401200,473900,FRIDAY,NH,W,WWH
Christ College ATM,06-02-2016,178,83,95,1011500,519500,492000,SATURDAY,NH,H,WHH
Christ College ATM,07-02-2016,134,60,74,581000,356900,224100,SUNDAY,NH,H,HHW
Christ College ATM,08-02-2016,116,58,58,579000,303700,275300,MONDAY,NH,W,HWW
Christ College ATM,09-02-2016,136,74,62,662400,427900,234500,TUESDAY,NH,W,WWW
Christ College ATM,10-02-2016,141,67,74,719000,408400,310600,WEDNESDAY,NH,W,WWW
Christ College ATM,11-02-2016,154,79,75,783000,499400,283600,THURSDAY,NH,W,WWW
Christ College ATM,12-02-2016,156,64,92,785800,399100,386700,FRIDAY,NH,W,WWH
Christ College ATM,13-02-2016,110,47,63,443800,221200,222600,SATURDAY,NH,H,WHH
Christ College ATM,14-02-2016,132,55,77,366800,150300,216500,SUNDAY,NH,H,HHW
Christ College ATM,15-02-2016,42,26,16,213900,167600,46300,MONDAY,NH,W,HWW
Christ College ATM,16-02-2016,135,63,72,507400,313200,194200,TUESDAY,NH,W,WWW
Christ College ATM,17-02-2016,160,71,89,795500,435800,359700,WEDNESDAY,NH,W,WWW
Christ College ATM,18-02-2016,143,67,76,512400,321300,191100,THURSDAY,NH,W,WWW
Christ College ATM,19-02-2016,162,56,106,734500,364700,369800,FRIDAY,NH,W,WWH
Christ College ATM,20-02-2016,148,58,90,812100,487900,324200,SATURDAY,NH,H,WHH
Christ College ATM,22-02-2016,203,61,142,957400,425100,532300,MONDAY,NH,W,HWW
Christ College ATM,23-02-2016,162,79,83,759800,440800,319000,TUESDAY,NH,W,WWW
Christ College ATM,24-02-2016,121,50,71,331200,142900,188300,WEDNESDAY,NH,W,WWW
Christ College ATM,25-02-2016,163,70,93,647600,397500,250100,THURSDAY,NH,W,WWW
Christ College ATM,26-02-2016,144,62,82,616100,318300,297800,FRIDAY,NH,W,WWH
Christ College ATM,27-02-2016,135,56,79,661300,311300,350000,SATURDAY,NH,H,WHH
Christ College ATM,28-02-2016,120,45,75,316400,130500,185900,SUNDAY,NH,H,HHW
Christ College ATM,29-02-2016,132,64,68,601500,285500,316000,MONDAY,NH,W,HWW
Christ College ATM,01-03-2016,109,64,45,514300,317200,197100,TUESDAY,NH,W,WWW
Christ College ATM,02-03-2016,61,30,31,279800,177300,102500,WEDNESDAY,NH,W,WWW
Christ College ATM,03-03-2016,137,65,72,742200,427600,314600,THURSDAY,NH,W,WWW
Christ College ATM,04-03-2016,135,71,64,800300,523700,276600,FRIDAY,NH,W,WWH
Christ College ATM,05-03-2016,150,78,72,963200,608600,354600,SATURDAY,NH,H,WHH
Christ College ATM,06-03-2016,119,58,61,421000,244500,176500,SUNDAY,NH,H,HHW
Christ College ATM,07-03-2016,202,70,132,876700,362200,514500,MONDAY,NH,W,HWW
Christ College ATM,08-03-2016,146,73,73,628200,299500,328700,TUESDAY,NH,W,WWW
Christ College ATM,09-03-2016,158,72,86,814800,417200,397600,WEDNESDAY,NH,W,WWW
Christ College ATM,10-03-2016,140,59,81,760900,343500,417400,THURSDAY,NH,W,WWW
Christ College ATM,11-03-2016,141,71,70,590300,375900,214400,FRIDAY,NH,W,WWH
Christ College ATM,12-03-2016,161,82,79,780100,457000,323100,SATURDAY,NH,H,WHH
Christ College ATM,13-03-2016,134,53,81,513300,250000,263300,SUNDAY,NH,H,HHW
Christ College ATM,14-03-2016,153,66,87,754200,445200,309000,MONDAY,NH,W,HWW
Christ College ATM,15-03-2016,127,64,63,602200,392500,209700,TUESDAY,NH,W,WWW
Christ College ATM,16-03-2016,121,62,59,569800,373900,195900,WEDNESDAY,NH,W,WWW
Christ College ATM,17-03-2016,140,71,69,729700,470700,259000,THURSDAY,NH,W,WWW
Christ College ATM,18-03-2016,103,54,49,462500,254500,208000,FRIDAY,NH,W,WWH
Christ College ATM,19-03-2016,125,63,62,611800,379600,232200,SATURDAY,NH,H,WHH
Christ College ATM,20-03-2016,107,50,57,308500,155400,153100,SUNDAY,NH,H,HHW
Christ College ATM,21-03-2016,146,74,72,740600,484900,255700,MONDAY,NH,W,HWW
Christ College ATM,22-03-2016,129,58,71,650000,385000,265000,TUESDAY,NH,W,WWW
Christ College ATM,23-03-2016,104,65,39,505900,320000,185900,WEDNESDAY,NH,W,WWW
Christ College ATM,24-03-2016,117,63,54,675900,495400,180500,THURSDAY,NH,W,WWH
Christ College ATM,25-03-2016,26,20,6,103100,96800,6300,FRIDAY,C,H,WHH
Christ College ATM,28-03-2016,137,76,61,592600,440500,152100,MONDAY,NH,W,HWW
Christ College ATM,29-03-2016,109,59,50,424900,307200,117700,TUESDAY,NH,W,WWW
Christ College ATM,30-03-2016,134,75,59,713100,463800,249300,WEDNESDAY,NH,W,WWW
Christ College ATM,31-03-2016,142,84,58,662700,396300,266400,THURSDAY,NH,W,WWW
Christ College ATM,01-04-2016,69,43,26,294100,196000,98100,FRIDAY,NH,W,WWH
Christ College ATM,02-04-2016,87,28,59,387200,147800,239400,SATURDAY,NH,H,WHH
Christ College ATM,03-04-2016,164,73,91,638600,284400,354200,SUNDAY,NH,H,HHW
Christ College ATM,04-04-2016,180,53,127,982000,375700,606300,MONDAY,NH,W,HWW
Christ College ATM,05-04-2016,132,48,84,591300,254300,337000,TUESDAY,NH,W,WWW
Christ College ATM,06-04-2016,222,101,121,1262600,617000,645600,WEDNESDAY,NH,W,WWW
Christ College ATM,07-04-2016,104,57,47,455200,266800,188400,THURSDAY,NH,W,WWH
Christ College ATM,11-04-2016,182,63,119,827600,372400,455200,MONDAY,NH,W,HWW
Christ College ATM,12-04-2016,151,83,68,773100,518900,254200,TUESDAY,NH,W,WWW
Christ College ATM,13-04-2016,185,75,110,1005600,536800,468800,WEDNESDAY,NH,W,WWH
Christ College ATM,14-04-2016,147,37,110,348300,92800,255500,THURSDAY,N,H,WHW
Christ College ATM,15-04-2016,186,83,103,905000,502600,402400,FRIDAY,NH,W,HWH
Christ College ATM,16-04-2016,161,82,79,882500,631700,250800,SATURDAY,NH,H,WHH
Christ College ATM,17-04-2016,4,2,2,900,300,600,SUNDAY,NH,H,HHW
Christ College ATM,18-04-2016,99,42,57,351700,175100,176600,MONDAY,NH,W,HWH
Christ College ATM,19-04-2016,100,48,52,529200,268800,260400,TUESDAY,H,H,WHW
Christ College ATM,20-04-2016,149,68,81,629900,284800,345100,WEDNESDAY,NH,W,HWW
Christ College ATM,21-04-2016,12,3,9,63200,26000,37200,THURSDAY,NH,W,WWW
Christ College ATM,22-04-2016,89,46,43,451100,271300,179800,FRIDAY,NH,W,WWH
Christ College ATM,23-04-2016,119,61,58,710700,426500,284200,SATURDAY,NH,H,WHH
Christ College ATM,24-04-2016,93,32,61,318000,137000,181000,SUNDAY,NH,H,HHW
Christ College ATM,25-04-2016,108,50,58,533900,298400,235500,MONDAY,NH,W,HWW
Christ College ATM,26-04-2016,102,50,52,470600,335300,135300,TUESDAY,NH,W,WWW
Christ College ATM,27-04-2016,103,57,46,446800,319000,127800,WEDNESDAY,NH,W,WWW
Christ College ATM,28-04-2016,86,31,55,328000,159600,168400,THURSDAY,NH,W,WWW
Christ College ATM,29-04-2016,142,63,79,772700,451200,321500,FRIDAY,NH,W,WWH
Christ College ATM,30-04-2016,175,74,101,1062700,520000,542700,SATURDAY,NH,H,WHH
Christ College ATM,01-05-2016,10,5,5,23700,15000,8700,SUNDAY,N,H,HHW
Christ College ATM,02-05-2016,138,41,97,673900,208100,465800,MONDAY,NH,W,HWW
Christ College ATM,03-05-2016,121,57,64,626200,325200,301000,TUESDAY,NH,W,WWW
Christ College ATM,04-05-2016,129,68,61,672300,392300,280000,WEDNESDAY,NH,W,WWW
Christ College ATM,05-05-2016,92,50,42,521000,373100,147900,THURSDAY,NH,W,WWW
Christ College ATM,06-05-2016,141,66,75,633800,334800,299000,FRIDAY,NH,W,WWH
Christ College ATM,07-05-2016,155,70,85,865900,460600,405300,SATURDAY,NH,H,WHH
Christ College ATM,08-05-2016,4,1,3,4500,200,4300,SUNDAY,NH,H,HHW
Christ College ATM,09-05-2016,96,43,53,485000,191600,293400,MONDAY,NH,W,HWW
Christ College ATM,10-05-2016,200,54,146,934600,319400,615200,TUESDAY,NH,W,WWW
Christ College ATM,11-05-2016,187,57,130,867800,385100,482700,WEDNESDAY,NH,W,WWW
Christ College ATM,12-05-2016,151,57,94,600500,308600,291900,THURSDAY,NH,W,WWW
Christ College ATM,13-05-2016,152,59,93,602200,319600,282600,FRIDAY,NH,W,WWH
Christ College ATM,14-05-2016,90,36,54,388300,174400,213900,SATURDAY,NH,H,WHH
Christ College ATM,17-05-2016,93,38,55,374800,188300,186500,TUESDAY,NH,W,WWW
Christ College ATM,18-05-2016,134,52,82,553800,246600,307200,WEDNESDAY,NH,W,WWW
Christ College ATM,19-05-2016,124,47,77,652900,323300,329600,THURSDAY,NH,W,WWW
Christ College ATM,20-05-2016,144,48,96,607800,308300,299500,FRIDAY,NH,W,WWH
Christ College ATM,21-05-2016,164,47,117,667700,201200,466500,SATURDAY,NH,H,WHH
Christ College ATM,22-05-2016,53,10,43,225800,33200,192600,SUNDAY,NH,H,HHW
Christ College ATM,23-05-2016,48,26,22,207900,145600,62300,MONDAY,NH,W,HWW
Christ College ATM,24-05-2016,12,9,3,61600,48100,13500,TUESDAY,NH,W,WWW
Christ College ATM,25-05-2016,64,33,31,295400,195600,99800,WEDNESDAY,NH,W,WWW
Christ College ATM,26-05-2016,105,44,61,567800,271900,295900,THURSDAY,NH,W,WWW
Christ College ATM,27-05-2016,101,46,55,494200,264200,230000,FRIDAY,NH,W,WWH
Christ College ATM,28-05-2016,100,45,55,416800,233400,183400,SATURDAY,NH,H,WHH
Christ College ATM,30-05-2016,124,51,73,669500,341200,328300,MONDAY,NH,W,HWW
Christ College ATM,31-05-2016,158,90,68,811000,504600,306400,TUESDAY,NH,W,WWW
Christ College ATM,01-06-2016,173,59,114,999100,351100,648000,WEDNESDAY,NH,W,WWW
Christ College ATM,02-06-2016,198,79,119,1214200,562200,652000,THURSDAY,NH,W,WWW
Christ College ATM,03-06-2016,98,45,53,501800,266600,235200,FRIDAY,NH,W,WWH
Christ College ATM,04-06-2016,130,57,73,754300,365500,388800,SATURDAY,NH,H,WHH
Christ College ATM,05-06-2016,165,70,95,644500,285600,358900,SUNDAY,NH,H,HHW
Christ College ATM,06-06-2016,48,18,30,193100,105500,87600,MONDAY,NH,W,HWW
Christ College ATM,07-06-2016,65,39,26,411600,295900,115700,TUESDAY,NH,W,WWW
Christ College ATM,08-06-2016,181,93,88,919000,631200,287800,WEDNESDAY,NH,W,WWW
Christ College ATM,09-06-2016,160,68,92,915700,522000,393700,THURSDAY,NH,W,WWW
Christ College ATM,10-06-2016,146,64,82,642600,353400,289200,FRIDAY,NH,W,WWH
Christ College ATM,11-06-2016,14,7,7,61500,28500,33000,SATURDAY,NH,H,WHH
Christ College ATM,13-06-2016,144,73,71,663800,368900,294900,MONDAY,NH,W,HWW
Christ College ATM,14-06-2016,136,74,62,718800,470600,248200,TUESDAY,NH,W,WWW
Christ College ATM,15-06-2016,138,69,69,743600,459900,283700,WEDNESDAY,NH,W,WWW
Christ College ATM,16-06-2016,175,80,95,869500,495700,373800,THURSDAY,NH,W,WWW
Christ College ATM,17-06-2016,103,50,53,538400,363000,175400,FRIDAY,NH,W,WWH
Christ College ATM,18-06-2016,149,81,68,765500,435800,329700,SATURDAY,NH,H,WHH
Christ College ATM,19-06-2016,124,44,80,615500,303100,312400,SUNDAY,NH,H,HHW
Christ College ATM,20-06-2016,137,77,60,762800,482600,280200,MONDAY,NH,W,HWW
Christ College ATM,21-06-2016,121,64,57,564800,372000,192800,TUESDAY,NH,W,WWW
Christ College ATM,22-06-2016,101,59,42,605100,442800,162300,WEDNESDAY,NH,W,WWW
Christ College ATM,23-06-2016,125,70,55,612800,454200,158600,THURSDAY,NH,W,WWW
Christ College ATM,24-06-2016,135,71,64,681600,447600,234000,FRIDAY,NH,W,WWH
Christ College ATM,25-06-2016,140,83,57,862300,696500,165800,SATURDAY,NH,H,WHH
Christ College ATM,26-06-2016,122,45,77,447200,150700,296500,SUNDAY,NH,H,HHW
Christ College ATM,27-06-2016,125,67,58,614600,442800,171800,MONDAY,NH,W,HWW
Christ College ATM,28-06-2016,125,68,57,519400,367200,152200,TUESDAY,NH,W,WWW
Christ College ATM,29-06-2016,129,49,80,649100,346200,302900,WEDNESDAY,NH,W,WWW
Christ College ATM,30-06-2016,136,69,67,648900,397300,251600,THURSDAY,NH,W,WWW
Christ College ATM,01-07-2016,165,66,99,1155400,524400,631000,FRIDAY,NH,W,WWH
Christ College ATM,02-07-2016,202,55,147,1056900,342500,714400,SATURDAY,NH,H,WHH
Christ College ATM,04-07-2016,187,81,106,1007800,486900,520900,MONDAY,NH,W,HWW
Christ College ATM,05-07-2016,164,86,78,765800,462800,303000,TUESDAY,NH,W,WWW
Christ College ATM,06-07-2016,184,80,104,1207600,633400,574200,WEDNESDAY,NH,W,WWH
Christ College ATM,07-07-2016,184,61,123,762700,313200,449500,THURSDAY,M,H,WHW
Christ College ATM,08-07-2016,189,77,112,1062900,547800,515100,FRIDAY,NH,W,HWH
Christ College ATM,09-07-2016,121,61,60,745300,447300,298000,SATURDAY,NH,H,WHH
Christ College ATM,11-07-2016,130,55,75,556800,306500,250300,MONDAY,NH,W,HWW
Christ College ATM,12-07-2016,120,75,45,585100,454100,131000,TUESDAY,NH,W,WWW
Christ College ATM,13-07-2016,227,90,137,1031200,539200,492000,WEDNESDAY,NH,W,WWW
Christ College ATM,14-07-2016,165,54,111,922500,377300,545200,THURSDAY,NH,W,WWW
Christ College ATM,15-07-2016,152,72,80,783700,465200,318500,FRIDAY,NH,W,WWH
Christ College ATM,16-07-2016,132,65,67,780300,477100,303200,SATURDAY,NH,H,WHH
Christ College ATM,17-07-2016,123,68,55,434200,317700,116500,SUNDAY,NH,H,HHW
Christ College ATM,18-07-2016,192,58,134,974100,440800,533300,MONDAY,NH,W,HWW
Christ College ATM,19-07-2016,195,77,118,961200,494500,466700,TUESDAY,NH,W,WWW
Christ College ATM,20-07-2016,163,62,101,818800,425800,393000,WEDNESDAY,NH,W,WWW
Christ College ATM,21-07-2016,168,74,94,593300,306100,287200,THURSDAY,NH,W,WWW
Christ College ATM,22-07-2016,138,76,62,665300,501100,164200,FRIDAY,NH,W,WWH
Christ College ATM,23-07-2016,147,75,72,735500,451400,284100,SATURDAY,NH,H,WHH
Christ College ATM,24-07-2016,72,45,27,98400,53900,44500,SUNDAY,NH,H,HHW
Christ College ATM,25-07-2016,128,48,80,535600,321700,213900,MONDAY,NH,W,HWW
Christ College ATM,26-07-2016,117,49,68,360400,195300,165100,TUESDAY,NH,W,WWW
Christ College ATM,27-07-2016,138,64,74,626700,336400,290300,WEDNESDAY,NH,W,WWW
Christ College ATM,28-07-2016,67,33,34,264300,172500,91800,THURSDAY,NH,W,WWW
Christ College ATM,29-07-2016,100,54,46,460100,317100,143000,FRIDAY,NH,W,WWH
Christ College ATM,30-07-2016,209,39,170,994100,234300,759800,SATURDAY,NH,H,WHH
Christ College ATM,31-07-2016,109,41,68,399600,222000,177600,SUNDAY,NH,H,HHW
Christ College ATM,01-08-2016,108,59,49,479100,250800,228300,MONDAY,NH,W,HWW
Christ College ATM,02-08-2016,101,39,62,419000,174500,244500,TUESDAY,NH,W,WWW
Christ College ATM,03-08-2016,201,103,98,1165100,717100,448000,WEDNESDAY,NH,W,WWW
Christ College ATM,04-08-2016,148,98,50,871300,667700,203600,THURSDAY,NH,W,WWW
Christ College ATM,05-08-2016,172,79,93,994300,553200,441100,FRIDAY,NH,W,WWH
Christ College ATM,06-08-2016,262,96,166,1322800,513800,809000,SATURDAY,NH,H,WHH
Christ College ATM,08-08-2016,55,33,22,301000,229800,71200,MONDAY,NH,W,HWW
Christ College ATM,09-08-2016,147,71,76,679800,387500,292300,TUESDAY,NH,W,WWW
Christ College ATM,10-08-2016,151,79,72,679500,452500,227000,WEDNESDAY,NH,W,WWW
Christ College ATM,11-08-2016,165,87,78,909400,568800,340600,THURSDAY,NH,W,WWW
Christ College ATM,12-08-2016,119,56,63,757100,478400,278700,FRIDAY,NH,W,WWH
Christ College ATM,13-08-2016,175,74,101,929500,536600,392900,SATURDAY,NH,H,WHH
Christ College ATM,14-08-2016,110,49,61,385000,165900,219100,SUNDAY,NH,H,HHH
Christ College ATM,15-08-2016,115,42,73,456600,210500,246100,MONDAY,N,H,HHW
Christ College ATM,16-08-2016,105,55,50,543200,387600,155600,TUESDAY,NH,W,HWW
Christ College ATM,17-08-2016,87,51,36,529000,383500,145500,WEDNESDAY,NH,W,WWW
Christ College ATM,18-08-2016,62,29,33,259600,157200,102400,THURSDAY,NH,W,WWW
Christ College ATM,19-08-2016,129,65,64,799000,497000,302000,FRIDAY,NH,W,WWH
Christ College ATM,20-08-2016,164,76,88,843100,552100,291000,SATURDAY,NH,H,WHH
Christ College ATM,21-08-2016,115,53,62,474100,259000,215100,SUNDAY,NH,H,HHW
Christ College ATM,22-08-2016,126,41,85,547800,218800,329000,MONDAY,NH,W,HWW
Christ College ATM,23-08-2016,139,56,83,553500,305200,248300,TUESDAY,NH,W,WWW
Christ College ATM,24-08-2016,114,57,57,604100,395300,208800,WEDNESDAY,NH,W,WWH
Christ College ATM,25-08-2016,130,63,67,655100,398000,257100,THURSDAY,H,H,WHW
Christ College ATM,26-08-2016,123,46,77,567500,315000,252500,FRIDAY,NH,W,HWH
Christ College ATM,27-08-2016,112,55,57,554800,377500,177300,SATURDAY,NH,H,WHH
Christ College ATM,28-08-2016,93,31,62,287600,152200,135400,SUNDAY,NH,H,HHW
Christ College ATM,29-08-2016,147,66,81,548300,267100,281200,MONDAY,NH,W,HWW
Christ College ATM,30-08-2016,111,67,44,561600,421300,140300,TUESDAY,NH,W,WWW
Christ College ATM,31-08-2016,148,73,75,873300,583500,289800,WEDNESDAY,NH,W,WWW
Christ College ATM,01-09-2016,211,91,120,1332600,643800,688800,THURSDAY,NH,W,WWW
Christ College ATM,02-09-2016,230,82,148,1073300,402000,671300,FRIDAY,NH,W,WWH
Christ College ATM,03-09-2016,225,71,154,1095700,369700,726000,SATURDAY,NH,H,WHH
Christ College ATM,04-09-2016,163,77,86,778900,485800,293100,SUNDAY,NH,H,HHH
Christ College ATM,05-09-2016,188,78,110,1125600,606400,519200,MONDAY,H,H,HHW
Christ College ATM,06-09-2016,182,68,114,1020200,422500,597700,TUESDAY,NH,W,HWW
Christ College ATM,07-09-2016,133,71,62,817600,469100,348500,WEDNESDAY,NH,W,WWW
Christ College ATM,08-09-2016,162,77,85,879900,522500,357400,THURSDAY,NH,W,WWW
Christ College ATM,09-09-2016,154,91,63,868800,651200,217600,FRIDAY,NH,W,WWH
Christ College ATM,10-09-2016,195,80,115,1011100,523200,487900,SATURDAY,NH,H,WHH
Christ College ATM,11-09-2016,117,58,59,503900,270300,233600,SUNDAY,NH,H,HHW
Christ College ATM,12-09-2016,172,79,93,988700,593500,395200,MONDAY,NH,W,HWH
Christ College ATM,13-09-2016,144,74,70,812900,479100,333800,TUESDAY,M,H,WHW
Christ College ATM,14-09-2016,169,86,83,762400,435400,327000,WEDNESDAY,NH,W,HWW
Christ College ATM,15-09-2016,134,66,68,730100,415700,314400,THURSDAY,NH,W,WWW
Christ College ATM,16-09-2016,94,52,42,412500,258500,154000,FRIDAY,NH,W,WWH
Christ College ATM,17-09-2016,152,82,70,1001300,688100,313200,SATURDAY,NH,H,WHH
Christ College ATM,18-09-2016,128,55,73,556500,264200,292300,SUNDAY,NH,H,HHW
Christ College ATM,19-09-2016,129,64,65,707300,443100,264200,MONDAY,NH,W,HWW
Christ College ATM,20-09-2016,138,77,61,812600,583000,229600,TUESDAY,NH,W,WWW
Christ College ATM,21-09-2016,147,74,73,737100,468300,268800,WEDNESDAY,NH,W,WWW
Christ College ATM,22-09-2016,109,54,55,463300,311200,152100,THURSDAY,NH,W,WWW
Christ College ATM,23-09-2016,130,84,46,699600,559100,140500,FRIDAY,NH,W,WWH
Christ College ATM,24-09-2016,129,76,53,762800,569500,193300,SATURDAY,NH,H,WHH
Christ College ATM,25-09-2016,123,55,68,468700,340100,128600,SUNDAY,NH,H,HHW
Christ College ATM,26-09-2016,172,75,97,798800,387400,411400,MONDAY,NH,W,HWW
Christ College ATM,27-09-2016,171,74,97,876700,520300,356400,TUESDAY,NH,W,WWW
Christ College ATM,28-09-2016,139,76,63,641600,451200,190400,WEDNESDAY,NH,W,WWW
Christ College ATM,29-09-2016,149,78,71,648900,378700,270200,THURSDAY,NH,W,WWW
Christ College ATM,30-09-2016,177,85,92,971700,584200,387500,FRIDAY,NH,W,WWH
Christ College ATM,01-10-2016,202,70,132,1207300,561000,646300,SATURDAY,NH,H,WHH
Christ College ATM,02-10-2016,220,56,164,876500,271700,604800,SUNDAY,N,H,HHW
Christ College ATM,03-10-2016,82,46,36,444600,321000,123600,MONDAY,NH,W,HWW
Christ College ATM,04-10-2016,140,72,68,639300,349100,290200,TUESDAY,NH,W,WWW
Christ College ATM,05-10-2016,17,10,7,90800,61400,29400,WEDNESDAY,NH,W,WWW
Christ College ATM,06-10-2016,178,87,91,997400,651500,345900,THURSDAY,NH,W,WWW
Christ College ATM,07-10-2016,208,97,111,1132900,663000,469900,FRIDAY,NH,W,WWH
Christ College ATM,08-10-2016,149,90,59,781600,529500,252100,SATURDAY,NH,H,WHH
Christ College ATM,09-10-2016,67,29,38,304900,149900,155000,SUNDAY,NH,H,HHH
Christ College ATM,10-10-2016,82,34,48,338500,126500,212000,MONDAY,H,H,HHH
Christ College ATM,13-10-2016,170,72,98,901500,492300,409200,THURSDAY,NH,W,HWW
Christ College ATM,14-10-2016,170,76,94,821000,468900,352100,FRIDAY,NH,W,WWH
Christ College ATM,15-10-2016,158,77,81,948700,621400,327300,SATURDAY,NH,H,WHH
Christ College ATM,16-10-2016,124,59,65,437500,285500,152000,SUNDAY,NH,H,HHW
Christ College ATM,17-10-2016,194,99,95,1152300,771700,380600,MONDAY,NH,W,HWW
Christ College ATM,18-10-2016,150,69,81,761100,431100,330000,TUESDAY,NH,W,WWW
Christ College ATM,19-10-2016,251,65,186,1182600,355800,826800,WEDNESDAY,NH,W,WWW
Christ College ATM,20-10-2016,136,66,70,769400,463300,306100,THURSDAY,NH,W,WWW
Christ College ATM,21-10-2016,94,48,46,462400,312800,149600,FRIDAY,NH,W,WWH
Christ College ATM,22-10-2016,152,65,87,821800,467700,354100,SATURDAY,NH,H,WHH
Christ College ATM,23-10-2016,156,53,103,650300,278100,372200,SUNDAY,NH,H,HHW
Christ College ATM,24-10-2016,176,97,79,1126300,755800,370500,MONDAY,NH,W,HWW
Christ College ATM,25-10-2016,163,88,75,848800,535800,313000,TUESDAY,NH,W,WWW
Christ College ATM,26-10-2016,198,96,102,940800,617600,323200,WEDNESDAY,NH,W,WWW
Christ College ATM,27-10-2016,234,111,123,1291100,775800,515300,THURSDAY,NH,W,WWW
Christ College ATM,28-10-2016,163,69,94,728500,393500,335000,FRIDAY,NH,W,WWH
Christ College ATM,29-10-2016,78,35,43,295900,176700,119200,SATURDAY,H,H,WHH
Christ College ATM,30-10-2016,69,34,35,253300,142100,111200,SUNDAY,NH,H,HHW
Christ College ATM,31-10-2016,196,79,117,1022100,512100,510000,MONDAY,NH,W,HWW
Christ College ATM,01-11-2016,141,59,82,697000,367100,329900,TUESDAY,NH,W,WWW
Christ College ATM,02-11-2016,154,60,94,808400,323900,484500,WEDNESDAY,NH,W,WWW
Christ College ATM,03-11-2016,54,25,29,309700,162700,147000,THURSDAY,NH,W,WWW
Christ College ATM,04-11-2016,1,0,1,2000,0,2000,FRIDAY,NH,W,WWH
Christ College ATM,05-11-2016,154,61,93,760900,323600,437300,SATURDAY,NH,H,WHH
Christ College ATM,06-11-2016,138,57,81,535000,259500,275500,SUNDAY,NH,H,HHW
Christ College ATM,07-11-2016,107,46,61,545700,313800,231900,MONDAY,NH,W,HWW
Christ College ATM,08-11-2016,233,121,112,966400,639900,326500,TUESDAY,NH,W,WWW
Christ College ATM,13-11-2016,1,0,1,7000,0,7000,SUNDAY,NH,H,HHW
Christ College ATM,22-11-2016,19,5,14,30000,7200,22800,TUESDAY,NH,W,WWW
Christ College ATM,28-11-2016,1,1,0,100,100,0,MONDAY,NH,W,HWW
Christ College ATM,29-11-2016,20,14,6,30700,23000,7700,TUESDAY,NH,W,WWW
Christ College ATM,30-11-2016,9,3,6,8200,400,7800,WEDNESDAY,NH,W,WWW
Christ College ATM,01-12-2016,1,1,0,1500,1500,0,THURSDAY,NH,W,WWW
Christ College ATM,07-12-2016,3,1,2,2600,2000,600,WEDNESDAY,NH,W,WWW
Christ College ATM,20-01-2017,2,0,2,6000,0,6000,FRIDAY,NH,W,WWH
Christ College ATM,21-01-2017,124,22,102,471300,89800,381500,SATURDAY,NH,H,WHH
Christ College ATM,22-01-2017,132,12,120,721700,53300,668400,SUNDAY,NH,H,HHW
Christ College ATM,23-01-2017,106,23,83,587200,100500,486700,MONDAY,NH,W,HWW
Christ College ATM,24-01-2017,169,28,141,695100,132200,562900,TUESDAY,NH,W,WWW
Christ College ATM,25-01-2017,146,33,113,620700,124600,496100,WEDNESDAY,NH,W,WWH
Christ College ATM,26-01-2017,194,24,170,891000,120300,770700,THURSDAY,N,H,WHW
Christ College ATM,27-01-2017,253,39,214,1238100,151500,1086600,FRIDAY,NH,W,HWH
Christ College ATM,28-01-2017,211,47,164,1189000,318700,870300,SATURDAY,NH,H,WHH
Christ College ATM,29-01-2017,13,2,11,42300,12000,30300,SUNDAY,NH,H,HHW
Christ College ATM,30-01-2017,133,23,110,487500,86100,401400,MONDAY,NH,W,HWW
Christ College ATM,31-01-2017,265,54,211,1201600,288400,913200,TUESDAY,NH,W,WWW
Christ College ATM,01-02-2017,313,75,238,1909500,436900,1472600,WEDNESDAY,NH,W,WWW
Christ College ATM,02-02-2017,267,45,222,1617200,212600,1404600,THURSDAY,NH,W,WWW
Christ College ATM,03-02-2017,168,34,134,1006300,146000,860300,FRIDAY,NH,W,WHH
Christ College ATM,04-02-2017,132,36,96,810600,226500,584100,SATURDAY,NH,H,WHH
Christ College ATM,05-02-2017,212,17,195,1243000,102400,1140600,SUNDAY,NH,H,HHW
Christ College ATM,06-02-2017,135,38,97,694000,222200,471800,MONDAY,NH,W,HWW
Christ College ATM,07-02-2017,220,63,157,1145700,324000,821700,TUESDAY,NH,W,WWW
Christ College ATM,08-02-2017,221,58,163,1149500,343400,806100,WEDNESDAY,NH,W,WWW
Christ College ATM,09-02-2017,104,27,77,403900,96500,307400,THURSDAY,NH,W,WWW
Christ College ATM,10-02-2017,99,18,81,395700,79400,316300,FRIDAY,NH,W,WWH
Christ College ATM,11-02-2017,19,4,15,96300,9200,87100,SATURDAY,NH,H,WHH
Christ College ATM,13-02-2017,110,18,92,520500,57300,463200,MONDAY,NH,W,HWW
Christ College ATM,14-02-2017,219,66,153,845500,354900,490600,TUESDAY,NH,W,WWW
Christ College ATM,15-02-2017,201,39,162,989800,240100,749700,WEDNESDAY,NH,W,WWW
Christ College ATM,16-02-2017,143,30,113,555000,109300,445700,THURSDAY,NH,W,WWW
Christ College ATM,17-02-2017,157,45,112,748200,295700,452500,FRIDAY,NH,W,WWH
Christ College ATM,18-02-2017,190,39,151,1037300,277100,760200,SATURDAY,NH,H,WHH
Christ College ATM,19-02-2017,141,26,115,614100,103300,510800,SUNDAY,NH,H,HHW
Christ College ATM,20-02-2017,162,39,123,671200,215200,456000,MONDAY,NH,W,HWW
Christ College ATM,21-02-2017,169,41,128,707100,225800,481300,TUESDAY,NH,W,WWW
Christ College ATM,22-02-2017,166,49,117,661100,264800,396300,WEDNESDAY,NH,W,WWW
Christ College ATM,23-02-2017,148,32,116,686300,188000,498300,THURSDAY,NH,W,WWW
Christ College ATM,24-02-2017,134,54,80,631100,317500,313600,FRIDAY,NH,W,WWH
Christ College ATM,25-02-2017,187,44,143,792600,244300,548300,SATURDAY,NH,H,WHH
Christ College ATM,26-02-2017,119,24,95,640000,140000,500000,SUNDAY,NH,H,HHW
Christ College ATM,27-02-2017,70,22,48,362600,152600,210000,MONDAY,NH,W,HWW
Christ College ATM,28-02-2017,223,57,166,1021500,315500,706000,TUESDAY,NH,W,WWW
Christ College ATM,01-03-2017,275,56,219,1539900,360900,1179000,WEDNESDAY,NH,W,WWW
Christ College ATM,02-03-2017,301,64,237,1614300,382600,1231700,THURSDAY,NH,W,WWW
Christ College ATM,03-03-2017,140,37,103,673200,157600,515600,FRIDAY,NH,W,WWH
Christ College ATM,04-03-2017,264,97,167,1462500,585200,877300,SATURDAY,NH,H,WHH
Christ College ATM,05-03-2017,139,35,104,511500,163600,347900,SUNDAY,NH,H,HHW
Christ College ATM,06-03-2017,225,51,174,936100,264500,671600,MONDAY,NH,W,HWW
Christ College ATM,07-03-2017,173,55,118,1090500,479300,611200,TUESDAY,NH,W,WWW
Christ College ATM,08-03-2017,202,65,137,843000,347600,495400,WEDNESDAY,NH,W,WWW
Christ College ATM,09-03-2017,267,70,197,1175700,378100,797600,THURSDAY,NH,W,WWW
Christ College ATM,10-03-2017,135,34,101,734500,242100,492400,FRIDAY,NH,W,WWH
Christ College ATM,13-03-2017,287,79,208,1255800,491600,764200,MONDAY,NH,W,HWW
Christ College ATM,14-03-2017,226,60,166,1189300,386800,802500,TUESDAY,NH,W,WWW
Christ College ATM,15-03-2017,249,74,175,1231100,506500,724600,WEDNESDAY,NH,W,WWW
Christ College ATM,16-03-2017,213,49,164,957500,326500,631000,THURSDAY,NH,W,WWW
Christ College ATM,17-03-2017,194,46,148,808200,335200,473000,FRIDAY,NH,W,WWH
Christ College ATM,18-03-2017,217,72,145,940600,520300,420300,SATURDAY,NH,H,WHH
Christ College ATM,19-03-2017,281,39,242,965500,171200,794300,SUNDAY,NH,H,HHW
Christ College ATM,20-03-2017,191,44,147,854500,221400,633100,MONDAY,NH,W,HWW
Christ College ATM,21-03-2017,137,45,92,593400,319300,274100,TUESDAY,NH,W,WWW
Christ College ATM,22-03-2017,109,26,83,407600,102000,305600,WEDNESDAY,NH,W,WWW
Christ College ATM,23-03-2017,159,41,118,640800,252300,388500,THURSDAY,NH,W,WWW
Christ College ATM,24-03-2017,161,49,112,631900,259600,372300,FRIDAY,NH,W,WWH
Christ College ATM,25-03-2017,159,67,92,820800,492800,328000,SATURDAY,NH,H,WHH
Christ College ATM,26-03-2017,3,2,1,22000,20000,2000,SUNDAY,NH,H,HHW
Christ College ATM,27-03-2017,216,48,168,1043800,366500,677300,MONDAY,NH,W,HWW
Christ College ATM,28-03-2017,188,56,132,942500,387000,555500,TUESDAY,NH,W,WWH
Christ College ATM,29-03-2017,227,60,167,1023000,466200,556800,WEDNESDAY,N,H,WHW
Christ College ATM,30-03-2017,164,47,117,842000,317900,524100,THURSDAY,NH,W,HWW
Christ College ATM,31-03-2017,276,102,174,1300300,600800,699500,FRIDAY,NH,W,WWH
Christ College ATM,01-04-2017,144,45,99,459000,134900,324100,SATURDAY,NH,H,WHH
Christ College ATM,02-04-2017,16,1,15,67300,100,67200,SUNDAY,NH,H,HHW
Christ College ATM,03-04-2017,13,8,5,46900,26500,20400,MONDAY,NH,W,HWW
Christ College ATM,04-04-2017,121,35,86,536100,127000,409100,TUESDAY,NH,W,WWW
Christ College ATM,05-04-2017,202,59,143,1048900,395700,653200,WEDNESDAY,NH,W,WWW
Christ College ATM,06-04-2017,190,34,156,977100,211800,765300,THURSDAY,NH,W,WWW
Christ College ATM,07-04-2017,239,90,149,1025400,503800,521600,FRIDAY,NH,W,WWH
Christ College ATM,08-04-2017,44,9,35,169600,46000,123600,SATURDAY,NH,H,WHH
Christ College ATM,09-04-2017,153,18,135,543300,55600,487700,SUNDAY,H,H,HHW
Christ College ATM,10-04-2017,205,43,162,942800,226900,715900,MONDAY,NH,W,HWW
Christ College ATM,11-04-2017,114,23,91,462100,150200,311900,TUESDAY,NH,W,WWW
Christ College ATM,12-04-2017,239,56,183,1164200,378500,785700,WEDNESDAY,NH,W,WWW
Christ College ATM,13-04-2017,216,37,179,989000,199800,789200,THURSDAY,NH,W,WWH
Christ College ATM,15-04-2017,258,52,206,1266600,313800,952800,SATURDAY,NH,H,HHH
Christ College ATM,16-04-2017,246,47,199,1028200,171300,856900,SUNDAY,NH,H,HHW
Christ College ATM,17-04-2017,226,39,187,1052300,219400,832900,MONDAY,NH,W,HWW
Christ College ATM,18-04-2017,111,39,72,565200,300600,264600,TUESDAY,NH,W,WWW
Christ College ATM,19-04-2017,2,2,0,5100,5100,0,WEDNESDAY,NH,W,WWW
Christ College ATM,20-04-2017,150,65,85,818800,490700,328100,THURSDAY,NH,W,WWW
Christ College ATM,21-04-2017,195,61,134,807000,263500,543500,FRIDAY,NH,W,WWH
Christ College ATM,22-04-2017,206,56,150,813700,247600,566100,SATURDAY,NH,H,WHH
Christ College ATM,23-04-2017,41,9,32,159100,51000,108100,SUNDAY,NH,H,HHW
Christ College ATM,24-04-2017,155,36,119,904000,322800,581200,MONDAY,NH,W,HWW
Christ College ATM,25-04-2017,161,44,117,756700,381000,375700,TUESDAY,NH,W,WWW
Christ College ATM,26-04-2017,211,69,142,782300,356800,425500,WEDNESDAY,NH,W,WWW
Christ College ATM,27-04-2017,194,46,148,688300,187000,501300,THURSDAY,NH,W,WWW
Christ College ATM,28-04-2017,30,7,23,152200,74100,78100,FRIDAY,NH,W,WWH
Christ College ATM,29-04-2017,113,28,85,585600,230700,354900,SATURDAY,NH,H,WHH
Christ College ATM,30-04-2017,162,23,139,691100,117900,573200,SUNDAY,NH,H,HHH
Christ College ATM,01-05-2017,267,38,229,1251800,225100,1026700,MONDAY,N,H,HHW
Christ College ATM,02-05-2017,222,52,170,1082700,341300,741400,TUESDAY,NH,W,HWW
Christ College ATM,03-05-2017,286,79,207,1283300,483500,799800,WEDNESDAY,NH,W,WWW
Christ College ATM,04-05-2017,183,40,143,804000,203800,600200,THURSDAY,NH,W,WWW
Christ College ATM,05-05-2017,259,43,216,1340300,298200,1042100,FRIDAY,NH,W,WWH
Christ College ATM,06-05-2017,190,34,156,1004800,208100,796700,SATURDAY,NH,H,WHH
Christ College ATM,07-05-2017,135,33,102,588700,135000,453700,SUNDAY,NH,H,HHW
Christ College ATM,08-05-2017,254,58,196,1398700,439700,959000,MONDAY,NH,W,HWW
Christ College ATM,09-05-2017,202,52,150,1115600,394600,721000,TUESDAY,NH,W,WWW
Christ College ATM,10-05-2017,240,50,190,1242600,353300,889300,WEDNESDAY,NH,W,WWW
Christ College ATM,11-05-2017,157,38,119,569000,154000,415000,THURSDAY,NH,W,WWW
Christ College ATM,12-05-2017,223,55,168,1073600,315300,758300,FRIDAY,NH,W,WWH
Christ College ATM,13-05-2017,245,70,175,1058800,400600,658200,SATURDAY,NH,H,WHH
Christ College ATM,14-05-2017,3,3,0,12000,12000,0,SUNDAY,NH,H,HHW
Christ College ATM,17-05-2017,134,43,91,533300,267500,265800,WEDNESDAY,NH,W,WWW
Christ College ATM,18-05-2017,171,37,134,859500,239800,619700,THURSDAY,NH,W,WWW
Christ College ATM,19-05-2017,243,79,164,1249600,485100,764500,FRIDAY,NH,W,WWH
Christ College ATM,20-05-2017,277,61,216,1307800,378500,929300,SATURDAY,NH,H,WHH
Christ College ATM,21-05-2017,253,49,204,974100,230800,743300,SUNDAY,NH,H,HHW
Christ College ATM,22-05-2017,159,46,113,851100,273300,577800,MONDAY,NH,W,HWW
Christ College ATM,23-05-2017,167,40,127,632700,272200,360500,TUESDAY,NH,W,WWW
Christ College ATM,24-05-2017,288,58,230,1077000,257500,819500,WEDNESDAY,NH,W,WWW
Christ College ATM,25-05-2017,223,42,181,1012500,240000,772500,THURSDAY,NH,W,WWW
Christ College ATM,26-05-2017,213,59,154,843700,311200,532500,FRIDAY,NH,W,WWH
Christ College ATM,27-05-2017,294,81,213,1328900,550300,778600,SATURDAY,NH,H,WHH
Christ College ATM,28-05-2017,42,13,29,116200,40300,75900,SUNDAY,NH,H,HHW
Christ College ATM,29-05-2017,129,41,88,468700,238700,230000,MONDAY,NH,W,HWW
Christ College ATM,30-05-2017,193,50,143,884600,299900,584700,TUESDAY,NH,W,WWW
Christ College ATM,31-05-2017,240,61,179,1173900,295000,878900,WEDNESDAY,NH,W,WWW
Christ College ATM,01-06-2017,326,73,253,1787800,413600,1374200,THURSDAY,NH,W,WWW
Christ College ATM,02-06-2017,250,52,198,1111500,278600,832900,FRIDAY,NH,W,WWH
Christ College ATM,03-06-2017,268,65,203,1331000,338900,992100,SATURDAY,NH,H,WHH
Christ College ATM,04-06-2017,47,19,28,173000,102500,70500,SUNDAY,NH,H,HHW
Christ College ATM,05-06-2017,308,68,240,1423200,367700,1055500,MONDAY,NH,W,HWW
Christ College ATM,06-06-2017,132,31,101,663400,230800,432600,TUESDAY,NH,W,WWW
Christ College ATM,07-06-2017,240,67,173,1304100,497500,806600,WEDNESDAY,NH,W,WWW
Christ College ATM,08-06-2017,239,52,187,1300500,356300,944200,THURSDAY,NH,W,WWW
Christ College ATM,09-06-2017,226,63,163,1188600,474400,714200,FRIDAY,NH,W,WWH
Christ College ATM,10-06-2017,216,77,139,1183800,592500,591300,SATURDAY,NH,H,WHH
Christ College ATM,11-06-2017,161,28,133,637300,204800,432500,SUNDAY,NH,H,HHW
Christ College ATM,12-06-2017,50,16,34,197300,105600,91700,MONDAY,NH,W,HWW
Christ College ATM,13-06-2017,204,62,142,1067500,439700,627800,TUESDAY,NH,W,WWW
Christ College ATM,14-06-2017,138,57,81,598900,319000,279900,WEDNESDAY,NH,W,WWW
Christ College ATM,15-06-2017,148,37,111,690600,265800,424800,THURSDAY,NH,W,WWW
Christ College ATM,16-06-2017,129,34,95,578600,212500,366100,FRIDAY,NH,W,WWH
Christ College ATM,17-06-2017,121,55,66,654400,442300,212100,SATURDAY,NH,H,WHH
Christ College ATM,18-06-2017,132,45,87,445800,214500,231300,SUNDAY,NH,H,HHW
Christ College ATM,19-06-2017,142,62,80,622900,401200,221700,MONDAY,NH,W,HWW
Christ College ATM,20-06-2017,121,57,64,549500,398200,151300,TUESDAY,NH,W,WWW
Christ College ATM,21-06-2017,61,19,42,316300,130000,186300,WEDNESDAY,NH,W,WWW
Christ College ATM,23-06-2017,84,35,49,309800,212900,96900,FRIDAY,NH,W,WWH
Christ College ATM,24-06-2017,170,64,106,778700,369900,408800,SATURDAY,NH,H,WHH
Christ College ATM,25-06-2017,131,29,102,455200,199300,255900,SUNDAY,NH,H,HHH
Christ College ATM,26-06-2017,175,49,126,591800,172200,419600,MONDAY,M,H,HHW
Christ College ATM,27-06-2017,127,41,86,532800,206900,325900,TUESDAY,NH,W,HWW
Christ College ATM,28-06-2017,63,26,37,293700,188500,105200,WEDNESDAY,NH,W,WWW
Christ College ATM,29-06-2017,127,35,92,585200,258100,327100,THURSDAY,NH,W,WWW
Christ College ATM,30-06-2017,182,58,124,964100,397400,566700,FRIDAY,NH,W,WWH
Christ College ATM,01-07-2017,260,66,194,1530000,516600,1013400,SATURDAY,NH,H,WHH
Christ College ATM,02-07-2017,129,27,102,510900,98100,412800,SUNDAY,NH,H,HHW
Christ College ATM,03-07-2017,171,74,97,1017700,620200,397500,MONDAY,NH,W,HWW
Christ College ATM,04-07-2017,156,57,99,743100,353400,389700,TUESDAY,NH,W,WWW
Christ College ATM,05-07-2017,265,80,185,1408000,567100,840900,WEDNESDAY,NH,W,WWW
Christ College ATM,06-07-2017,198,58,140,1035400,397800,637600,THURSDAY,NH,W,WWW
Christ College ATM,07-07-2017,134,45,89,642500,293600,348900,FRIDAY,NH,W,WWH
Christ College ATM,08-07-2017,276,86,190,1379300,558000,821300,SATURDAY,NH,H,WHH
Christ College ATM,09-07-2017,106,23,83,389000,74300,314700,SUNDAY,NH,H,HHW
Christ College ATM,10-07-2017,210,57,153,986500,368600,617900,MONDAY,NH,W,HWW
Christ College ATM,11-07-2017,111,53,58,747100,453900,293200,TUESDAY,NH,W,WWW
Christ College ATM,12-07-2017,113,40,73,484100,228700,255400,WEDNESDAY,NH,W,WWW
Christ College ATM,13-07-2017,148,53,95,790000,406400,383600,THURSDAY,NH,W,WWW
Christ College ATM,14-07-2017,128,48,80,505300,245800,259500,FRIDAY,NH,W,WWH
Christ College ATM,15-07-2017,173,64,109,876000,404800,471200,SATURDAY,NH,H,WHH
Christ College ATM,16-07-2017,125,45,80,438600,219000,219600,SUNDAY,NH,H,HHW
Christ College ATM,17-07-2017,144,64,80,783400,557000,226400,MONDAY,NH,W,HWW
Christ College ATM,18-07-2017,120,31,89,549100,223900,325200,TUESDAY,NH,W,WWW
Christ College ATM,19-07-2017,68,24,44,257900,118200,139700,WEDNESDAY,NH,W,WWW
Christ College ATM,20-07-2017,123,47,76,483700,232600,251100,THURSDAY,NH,W,WWW
Christ College ATM,21-07-2017,107,43,64,550900,285600,265300,FRIDAY,NH,W,WWH
Christ College ATM,22-07-2017,162,77,85,987800,672400,315400,SATURDAY,NH,H,WHH
Christ College ATM,23-07-2017,80,33,47,184100,115700,68400,SUNDAY,NH,H,HHW
Christ College ATM,24-07-2017,114,46,68,532900,311500,221400,MONDAY,NH,W,HWW
Christ College ATM,25-07-2017,144,57,87,692700,369500,323200,TUESDAY,NH,W,WWW
Christ College ATM,26-07-2017,81,44,37,326500,235000,91500,WEDNESDAY,NH,W,WWW
Christ College ATM,27-07-2017,124,52,72,523700,337600,186100,THURSDAY,NH,W,WWW
Christ College ATM,28-07-2017,141,57,84,586500,307000,279500,FRIDAY,NH,W,WWH
Christ College ATM,29-07-2017,162,63,99,765700,391800,373900,SATURDAY,NH,H,WHH
Christ College ATM,30-07-2017,135,37,98,391300,129300,262000,SUNDAY,NH,H,HHW
Christ College ATM,31-07-2017,164,61,103,892000,352100,539900,MONDAY,NH,W,HWW
Christ College ATM,01-08-2017,140,50,90,701500,271600,429900,TUESDAY,NH,W,WWW
Christ College ATM,02-08-2017,55,13,42,380600,104200,276400,WEDNESDAY,NH,W,WWW
Christ College ATM,03-08-2017,85,37,48,357100,174100,183000,THURSDAY,NH,W,WWW
Christ College ATM,04-08-2017,168,72,96,758400,459100,299300,FRIDAY,NH,W,WWH
Christ College ATM,05-08-2017,137,43,94,739100,265800,473300,SATURDAY,NH,H,WHH
Christ College ATM,06-08-2017,116,44,72,655400,337700,317700,SUNDAY,NH,H,HHW
Christ College ATM,07-08-2017,56,20,36,305500,121600,183900,MONDAY,NH,W,HWW
Christ College ATM,08-08-2017,47,22,25,159800,73000,86800,TUESDAY,NH,W,WWW
Christ College ATM,09-08-2017,106,42,64,440600,190800,249800,WEDNESDAY,NH,W,WWW
Christ College ATM,10-08-2017,141,61,80,776400,463200,313200,THURSDAY,NH,W,WWW
Christ College ATM,11-08-2017,161,73,88,845600,506500,339100,FRIDAY,NH,W,WWH
Christ College ATM,12-08-2017,27,14,13,97200,64800,32400,SATURDAY,NH,H,WHH
Christ College ATM,18-08-2017,83,32,51,338300,167200,171100,FRIDAY,NH,W,WWH
Christ College ATM,19-08-2017,164,58,106,746300,407500,338800,SATURDAY,NH,H,WHH
Christ College ATM,20-08-2017,116,42,74,459700,221300,238400,SUNDAY,NH,H,HHW
Christ College ATM,21-08-2017,125,55,70,586100,309900,276200,MONDAY,NH,W,HWW
Christ College ATM,22-08-2017,174,59,115,671400,338800,332600,TUESDAY,NH,W,WWW
Christ College ATM,23-08-2017,106,51,55,541300,365800,175500,WEDNESDAY,NH,W,WWW
Christ College ATM,24-08-2017,108,47,61,617100,376400,240700,THURSDAY,NH,W,WWH
Christ College ATM,25-08-2017,118,40,78,594800,241800,353000,FRIDAY,H,H,WHH
Christ College ATM,26-08-2017,37,20,17,189200,126000,63200,SATURDAY,NH,H,HHH
Christ College ATM,28-08-2017,132,46,86,690700,407300,283400,MONDAY,NH,W,HWW
Christ College ATM,29-08-2017,171,54,117,789600,361100,428500,TUESDAY,NH,W,WWW
Christ College ATM,30-08-2017,201,69,132,941600,472700,468900,WEDNESDAY,NH,W,WWW
Christ College ATM,31-08-2017,171,55,116,841100,314900,526200,THURSDAY,NH,W,WWW
Christ College ATM,01-09-2017,266,71,195,1663200,555500,1107700,FRIDAY,NH,W,WWH
Christ College ATM,02-09-2017,178,51,127,804700,250900,553800,SATURDAY,M,H,WHH
Christ College ATM,03-09-2017,79,19,60,390900,73300,317600,SUNDAY,NH,H,HHW
Christ College ATM,04-09-2017,265,84,181,1349000,610200,738800,MONDAY,NH,W,HWW
Christ College ATM,05-09-2017,222,83,139,1253300,659300,594000,TUESDAY,NH,W,WWW
Christ College ATM,06-09-2017,244,95,149,1488000,764400,723600,WEDNESDAY,NH,W,WWW
Christ College ATM,07-09-2017,261,85,176,1334600,542700,791900,THURSDAY,NH,W,WWW
Christ College ATM,08-09-2017,216,69,147,1046600,352800,693800,FRIDAY,NH,W,WWH
Christ College ATM,09-09-2017,232,79,153,1182900,528000,654900,SATURDAY,NH,H,WHH
Christ College ATM,10-09-2017,78,17,61,208900,70400,138500,SUNDAY,NH,H,HHW
Christ College ATM,11-09-2017,251,82,169,1413500,548900,864600,MONDAY,NH,W,HWW
Christ College ATM,12-09-2017,151,55,96,608600,298200,310400,TUESDAY,NH,W,WWW
Christ College ATM,13-09-2017,151,57,94,696700,377000,319700,WEDNESDAY,NH,W,WWW
Christ College ATM,14-09-2017,153,63,90,753300,407600,345700,THURSDAY,NH,W,WWW
Christ College ATM,15-09-2017,154,60,94,556800,242500,314300,FRIDAY,NH,W,WWH
Christ College ATM,16-09-2017,185,74,111,832900,435900,397000,SATURDAY,NH,H,WHH
Christ College ATM,17-09-2017,140,35,105,489100,202900,286200,SUNDAY,NH,H,HHW
Christ College ATM,18-09-2017,204,65,139,906200,459700,446500,MONDAY,NH,W,HWW
Christ College ATM,19-09-2017,150,40,110,590500,223700,366800,TUESDAY,NH,W,WWW
Christ College ATM,20-09-2017,109,26,83,398000,82300,315700,WEDNESDAY,NH,W,WWW
Christ College ATM,21-09-2017,169,51,118,847100,357200,489900,THURSDAY,NH,W,WWW
Christ College ATM,22-09-2017,78,29,49,337700,178900,158800,FRIDAY,NH,W,WWH
Christ College ATM,23-09-2017,257,67,190,1253100,446000,807100,SATURDAY,NH,H,WHH
Christ College ATM,24-09-2017,71,19,52,270700,112300,158400,SUNDAY,NH,H,HHW
Christ College ATM,25-09-2017,174,52,122,755300,310800,444500,MONDAY,NH,W,HWW
Christ College ATM,26-09-2017,110,34,76,325300,76000,249300,TUESDAY,NH,W,WWW
Christ College ATM,27-09-2017,149,46,103,722600,318100,404500,WEDNESDAY,NH,W,WWW
Christ College ATM,28-09-2017,187,76,111,1120300,549100,571200,THURSDAY,NH,W,WWH
Christ College ATM,29-09-2017,143,61,82,700400,364200,336200,FRIDAY,H,H,WHH
